aachen|AA K EH0 N
abbe|AE B EH
abbot|AE B AO T
aboensisk|AE B UH EH N S IH S K
abstinens|AE B S T IH N EH N S
abstinensbesvär|AE B S T IH N EH N S B EH0 S V AE RRR
accent|AE K S EH N T
acetylsalicylsyra|AE S EH T Y UW1 L S AE L IH S Y UW1 L S Y UW1 RRR AE
ackja|AE K Y AE
ackusativ|AE K UH S AE T IY V
adde|AE D EH
adel|AA D EH L
adelssläkt|AO D AH0 L S S L EH K T
adhd|AA D EH0 HH OW0 D EH0
adjektiv|AE D Y EH K T IY V
adjö|AE Y OE
adla|AA D L AE
adlig|AA D L IH G
advent|AE D V EH N T
adventsljusstake|AE D V EH N T S Y UW S S T AA K EH
advokat|AE D V UH K AA T
affrikata|AE F RRR IH K AA T AE
affär|AE F EH RRR
afse|AE F S EH
afton|AE F T AO N
aftonfalk|AE F T AO N F AE L K
aggressiv|AE G RRR EH S IY V
agna|AE NG N AE
agneta|AE NG N EH0 T AE
agnosticism|AE G N AO S T IH S IH S M
agnostiker|AE G N AO S T IH K EH RRR
aioli|AE Y OW0 L IH
akaciames|AE K AA S IY Y AE M EH0 S
aktie|AE K T S IH EH
aktiebolag|AE K T S IY EH B UH L AA G
aktuell|AE K T UH EH L
akut|AE K UW T
al|AA L
albatross|AE L B AE T RRR AO S
albert|AE L B AE T
albertina|AE L B AE T IY N AE
albin|AE L B IH N
aldrig|AE L D RRR IY G
alert|AE L AE T
alfabet|AE L F AE B EH0 T
alfågel|AA L F OW0 G EH L
alförrädare|AA L F ER R EH D AE R EH
alg|AE L Y
algerier|AE L EH0 RRR IH EH RRR
algeriet|AE L EH RRR IY EH T
algerisk|AE L EH0 RRR IH S K
alkekung|AE L K EH K UH NG
alkohol|AE L K UH HH OW0 L
alkoholism|AE L K UH HH UH L IH S M
alkoholist|AE L K UH HH UH L IH S T
alla|AE L AE
allemansrätt|AE L EH M AE N S RRR EH T
allihop|AE L IH HH UW P
allihopa|AE L IH HH UW P AE
allmän|AE L M EH N
allmänbildning|AE L M EH N B IH L D N IH NG
alltmer|AE L T M EH0 RRR
alltså|AE L T S AO
allvarlig|AE L V AA RRR L IH G
allé|AE L EH0
alpseglare|AE L P S EH0 G L AE R EH
altruism|AE L T RRR UH IH S M
aluminium|AE L UH M IY N IH UH M
amanda|AE M AE N D AE
ambitiös|AE M B IY OE S
amerika|AE M EH0 RRR IH K AE
amma|AE M AE
amper|AE M P EH RRR
ampere|AE M P AE RRR
amurfalk|AA M UH RRR F AE L K
ana|AA N AE
and|AE N D
anden|AE N D EH N
andlig|AE N D L IH G
andra|AE N D RRR AE
andré|AE N D RRR EH0
anfalla|AE N F AE L AE
ange|AE N Y EH0
anka|AE NG K AE
ankeborg|AE NG K EH B AO RRR Y
anklagelse|AE N K L AA G EH L S EH
anna|AE N AE
annons|AE N AO NG S
anod|AE N UW D
anomali|AE N UH M AE L IY
ansat|AE N S AE T
ansatt|AE N S AE T
ansikte|AE N S IH K T AH0
anspråk|AE N S P RRR OW0 K
ansvarig|AE N S V AA RRR IH G
antepenultima|AE N T EH P EH N UH L T IH M AE
antimon|AE N T IH M UW N
antisemit|AE N T IH S EH M IY T
antisemitisk|AE N T IH S EH M IY T IH S K
antisemitism|AE N T IH S EH M IH T IH S M
antyda|AE N T Y UW1 D AE
apa|AA P AE
apelsinjuice|AE P EH L S IY N Y UW S
apotek|AE P UH T EH0 K
appellativ|AE P EH L AE T IY V
april|AE P RRR IH L
arbetslös|AE RRR B EH0 T S L OE S
arbus|AA RRR B UW S
arg|AE RRR Y
argon|AE RRR G OW0 N
argt|AE RRR Y T
arkimedes|AE RRR K IH M EH0 D EH S
arkitekt|AE RRR SH IH T EH K T
arkiv|AE RRR K IY V
arr|AE RRR
arrangemang|AE RRR AE N EH0 M AE NG
arrangera|AE RRR AE N EH0 RRR AE
arsel|AE RRR S EH L
arsenik|AE RRR S EH N IY K
arton|AA RRR T AO N
arv|AE RRR V
as|AA S
aspig|AE S P IH G
asturisk|AE S T UW RRR IH S K AE
asturiska|AE S T UW RRR IH S K AE
att|AO
attack|AE T AE K
attityd|AE T IH T Y UW1 D
aubergin|AO B EH RRR SH IH N
aubergine|AO B EH RRR SH IH N
augusti|AE UH G UH S T IH
aula|AE UH L AE
av|AA V
avbrott|AA V B RRR AO T
avfärda|AA V F EH RRR D AE
avgjord|AA V Y UW RRR D
avgå|AA V G OW0
avgång|AA V G AO NG
avgöra|AA V Y OE RRR AE
avi|AE V IY
avlat|AA V L AA T
avlatskrämare|AA V L AA T S K RRR EH M AE RRR EH
avled|AA V L EH0 D
avokado|AE V UH K AA D UH
avseende|AA V S EH0 EH N D EH
avsiktlig|AA V S IY K T L IY
avsked|AA V EH0 D
avsky|AA V Y UW1
avskyvärd|AA V V EH RRR D
avsluta|AA V S L UW T AE
aw|AA V EH0
axel|AE K S EH L
ba|B AA
babbe|B AE B EH
babylift|B EH IH B L IH F T
backsvala|B AE K S V AA L AE
bad|B AA D
bada|B AA D AE
badensisk|B AE D EH N S IH S K
badstuga|B AA D S T UW G AE
bagage|B AE G AA
bajen|B AE Y EH N
bajs|B AE Y S
bajsa|B AE Y S AE
bak|B AA K
bakbord|B AE K B UW RRR D
balkansångare|B AE L K AE N S AO NG AE RRR EH
ball|B AE L
balle|B AE L EH
bamba|B AE M B AE
bambamat|B AE M B AE M AA T
bambarast|B AE M B AE RRR AE S T
bambatant|B AE M B AE T AE N T
bana|B AA N AE
banan|B AA N AE N
bananskal|B AE N AA N S K AA L
band|B AE N D
bane|B AA N EH
baneman|B AA N EH M AE N
bank|B AE NG K
bar|B AA RRR
bara|B AA RRR AE
barcelona|B AE SH EH L OW0 N AE
barmhärtig|B AE RRR M HH EH T IH G
barn|B AA RRR N
barnbespisning|B AA RRR N B EH S P IY S N IH NG
barnet|B AA RRR N EH T
barnhem|B AA RRR N HH EH M
barnmorska|B AA RRR N M UH RRR S K AE
barriär|B AE RRR IH AE RRR
barsk|B AE SH K
bas|B AA S
basar|B AE S AA RRR
basket|B AA S K EH T
basta|B AE S T AE
bea|B EH0 AE
bearbeta|B EH0 AE RRR B EH0 T AE
bebop|B IY B AO P
beckasin|B EH K AE S IY N
beckasinsnäppa|B EH K AE S IY N S N EH P AE
bedrägeri|B EH D RRR EH G EH RRR IY
begå|B AH0 G OW0
behov|B EH HH UW V
beige|B EH
bekant|B AH0 K AE N T
belgien|B EH L G IH EH N
ben|B EH0 N
berg|B EH RRR Y
bergand|B EH R Y AE N D
bergen|B EH RRR Y EH N
bergens|B EH RRR Y EH N S
berget|B EH RRR Y EH T
bergets|B EH RRR Y EH T S
bergs|B EH RRR Y S
bergsångare|B EH RRR Y S AO NG AE RRR EH
bergtajgasångare|B EH RRR Y T AE Y G AE S AO NG AE RRR EH
bergtita|B EH R Y T IY T AE
berguv|B EH RRR Y UW V
berlin|B EH0 RRR L IY N
bert|B AE T
beryllium|B EH RRR L IH UH M
besk|B EH S K
besked|B EH EH0 D
bespisa|B EH0 S P IY S AE
bespisning|B EH S P IY S N IH NG
bestrida|B EH S T RRR IY D AE
besvika|B EH S V IY K AE
besökare|B EH S OE K AE RRR EH
beta|B EH T AA
betala|B EH T AA L AE
bete|B EH T EH0
beteende|B EH T EH0 EH N D EH
betyda|B EH T Y UW1 D AE
betydelse|B EH T Y UW1 D EH L S EH
bi|B IY
bikini|B IH K IY N IH
bil|B IY L
bilist|B IH L IH S T
biljard|B IH L Y AA RRR D
biljon|B IH L Y UW N
bill|B IH L
bilparkering|B IY L P AE RRR K EH0 RRR IH NG
biologi|B IH UH L UH G IY
birgitta|B IH RRR G IH T AE
biskop|B IY S K AO P
bit|B IH T
bits|B IH T S
bitvarg|B IY T V AE RRR Y
biätare|B IY EH T AE RRR EH
bjuda|B Y UW D AE
bjugg|B Y UH G
bjöd|B Y OE D
björn|B Y OE RRR N
blad|B L AA D
blandinaviska|B L AE N D IH N AA V IH S K AE
blandning|B L AE N D N IY NG
blankspola|B L AE NG K S P UW L AE
bleck|B L EH K
blev|B L EH0 V
bli|B L IY
blida|B L IY D AE
block|B L AO K
blod|B L UW D
blodröd|B L UW D RRR OE D
blodtörst|B L UW D T UH SH T
blodtörstig|B L UW D T UH SH T IH G
blogg|B L AO G
blomma|B L UH M AE
blomqvist|B L UH M K V IH S T
blott|B L AO T
bly|B L Y UW1
blyg|B L Y UW1 G
bläck|B L EH K
bläs|B L EH S
bläsand|B L EH S AE N D
bläsgås|B L EH S G OW0 S
blå|B L OW0
blåbär|B L OW0 B EH RRR
blåkråka|B L OW0 K RRR OW0 K AE
blåljus|B L OW0 Y UW S
blåljuscentral|B L OW0 Y UW S S EH0 N T RRR AA L
blåljusfilter|B L OW0 Y UW S F IH L T EH RRR
blåljusfordon|B L OW0 Y UW S F UW RRR D UW N
blåljuspersonal|B L OW0 Y UW S P EH SH UH N AA L
blåst|B L AO S T
blåtand|B L OW0 T AE N D
blått|B L AO T
bo|B UW
boden|B UW D EH N
bodil|B UW D IH L
boel|B UW EH L
bog|B UW G
bok|B UW K
boka|B UW K AE
bokhandel|B UW K HH AE N D EH L
bokstav|B UH K S T AA V
bolaget|B UW L AA G EH T
bon|B UW N
bondska|B UH N D S K AE
boning|B UW N IH NG
bop|B AO P
bor|B UW RRR
bord|B UW D
borde|B UW D AH0
bordsbön|B UW RRR D S B OE N
bordtennis|B UW D T EH N IH S
boren|B UW RRR EH N
bortaplan|B AO RRR T AE P L AA N
bortskänka|B AO RRR T EH NG K EH S
bostad|B UW S T AA D
bot|B AO T
bota|B UW T AE
botar|B UW T AE RRR
bourgeoisie|B AO SH AO AE S IY
bov|B UW V
bra|B RRR AO
braig|B RRR AA IH G
brand|B RRR AE N D
brandskatta|B RRR AE N D S K AE T AE
brasklapp|B RRR AE S K L AE P
bre|B RRR EH0
brev|B RRR EH0 V
brevbärare|B RRR EH0 V B AE RRR AE RRR EH0
brinna|B RRR IH N AE
bris|B RRR IY S
brista|B RRR IH S T AE
bro|B RRR UW
bron|B RRR UW N
brons|B RRR AO N S
bronsibis|B RRR AO N S IY B IH S
bror|B RRR UW RRR
brorsa|B RRR UH SH AE
bros|B RRR UW S
broschyr|B RRR UH Y UW1 RRR
brud|B RRR UW D
brun|B RRR UW N
brunand|B R UW N AE N D
brunch|B RRR UH N
bruno|B RRR UW N UH
brunsenap|B RRR UW N S EH0 N AE P
brunsångare|B RRR UW N S AO NG AE RRR EH
brus|B RRR UW S
brushane|B RRR UW S HH AA N EH
brygd|B RRR G D
bryggd|B RRR G D
brylling|B RRR L IH NG
brytning|B RRR Y UW1 T N IH NG
bröd|B RRR OE D
bröt|B RRR OE T
bu|B UW
bud|B UW D
budgetpromenaden|B UH D Y EH T P RRR UH M EH N AA D EH N
bulle|B UH L EH
bur|B UW RRR
burdus|B UH RRR D UW S
buren|B UW RRR EH N
bus|B UW S
busig|B UW S IH G
busksångare|B UH S K S AO NG AE RRR EH
buss|B UH S
bussarong|B UH S AE RRR AO NG
busstation|B UH S S T AE UW N
bygd|B G D
bygga|B G AE
byling|B Y UW1 L IH NG
byrå|B RRR OW0
byte|B Y UW1 T EH
byxis|B K S IH S
bäckna|B EH K N AE
bältdjur|B EH L T Y UW RRR
bäng|B EH NG
bär|B EH RRR
bärs|B AE RRR S
bärsa|B AE RRR S AE
bävergäll|B EH V EH RRR Y EH L
båda|B OW0 D AE
både|B OW0 D EH
båge|B OW0 G EH
bål|B OW0 L
bår|B OW0 RRR
båt|B OW0 AH0 T
böcker|B OE K AH0 RRR
bödel|B OE D EH L
bög|B OE G
bögig|B OE G IH G
böra|B ER RRR AE
c|S EH0
café|K AE F EH0
californium|K AE L IH F OW0 RRR N IH UH M
calla|K OW0 L AE
calle|K AE L EH
carina|K AE RRR IY N AE
carl|K AA RRR L
carpmes|K AE R P M EH0 S
centimeter|S EH N T IH M EH0 T EH RRR
centralort|S EH N T RRR AA L UH RRR T
cesium|S EH0 S IH UH M
cettisångare|S EH T IH S AO NG AE RRR EH
champagne|AE M P AE N Y
champinjon|AE M P IH N Y UW N
chans|AE NG S
chark|AE RRR K
charkuteri|AE RRR K UH T EH RRR IY
charlie|SH AA L IH
charlotta|AE RRR L OW0 T AE
charlotte|AE L OW0 T
charm|AE RRR M
charmör|AE RRR M RRR
chaufför|AO F ER RRR
check|SH EH K
cheddar|SH EH D AE RRR
chef|EH F
chips|SH IH P S
choklad|UH K L AA D
cineast|S IH N EH0 AE S T
citron|S IH T RRR UW N
clown|K L AE UH N
clownfisk|K L AE UH N F IH S K
container|K AO N T EH Y N EH RRR
cool|K UW L
cowboy|K AE UH B AO Y
croissant|K RRR UH AE S AE NG
cup|K UH P
cyberattack|S Y UW1 B EH RRR AE T AE K
cykel|S K EH0 L
dadel|D AA D EH L
dag|D AA G
dags|D AA G S
dam|D AA M
damm|D AE M
dammsnäppa|D AE M S N EH P AE
dan|D AA N
danmark|D AE N M AE RRR K
dansk|D AE N S K
danska|D AE N S K AE
danskjävel|D AE N S K Y EH V EH L
dativ|D AA T IY V
dator|D AA T UH RRR
de|D IH
december|D EH S EH M B EH RRR
decennium|D EH S EH N IH UH M
decimeter|D EH S IH M EH0 T EH RRR
definition|D EH F IH N IH UW N
deg|D EH0 G
dekameter|D EH K AE M EH0 T EH RRR
dela|D EH0 L AE
dem|D AO M
den|D EH N
denne|D EH N EH
design|D EH S AE Y N
designa|D IH S AE Y N AE
dessa|D EH S AE
dessutom|D EH0 S UW T AO M
det|EH T
detektiv|D EH T EH K T IY V
detta|D EH T AE
dig|D EH Y
digitaliseringsminister|D IH G IH T AE L IH S EH0 RRR IH NG S M IH N IH S T EH RRR
dimmig|D IH M IH G
ding|D IH NG
dirr|D IH RRR
diskrepans|D IH S K RRR EH P AE NG S
diskussion|D IH S K UH UW N
djungel|Y UH NG EH L
djup|Y UW P
djuphav|Y UW P HH AA V
djupt|Y UW P T
djur|Y UW RRR
djärv|Y EH RRR V
djävla|Y EH V L AE
dock|D AO K
dog|D UW G
dogg|D AO G
doktor|D AO K T AO RRR
dom|D UH M
dopparedagen|D AO P AE RRR EH D AA G EH N
dopping|D AO P IH NG
dos|D UW S
dra|D RRR AA
dragen|D RRR AA G EH N
dragon|D RRR AE G UW N
dragspel|D RRR AA G S P EH0 L
drake|D RRR AA K EH
dras|D RRR AA S
dressing|D RRR EH0 S IY NG
dricka|D RRR IH K AE
dricker|D RRR IH K EH0 RRR
drillsnäppa|D RRR IH L S N EH P AE
driva|D RRR IY V AE
drivkraft|D RRR IY V K RRR AE F T
drog|D RRR UW G
drogs|D RRR UW G S
dromedar|D RRR UH M EH D AA RRR
droppen|D RRR AO P EH N
dryg|D RRR Y UW1 G
dränera|D RRR EH N EH0 RRR AE
dräng|D RRR EH NG
dröm|D RRR ER M
drös|D RRR OE S
du|D UW
dubbel|D UH B EH L
dubbelbeckasin|D UH B EH L B EH K AE S IY N
dubbelgångare|D UH B EH L G AO NG AE RRR EH
dubiös|D UH B IH OE S
duk|D UW K
dum|D UH M
dumbom|D UH M B UH M
dumhuvud|D UH M HH UH V UH D
dun|D UW N
dusch|D UH
duscha|D UH AE
dussin|D UH S IH N
dvärg|D V EH RRR Y
dvärgalåt|D V EH RRR Y AE L OW0 T
dvärgbeckasin|D V EH RRR Y B EH K AE S IY N
dvärgkanadagås|D V EH R Y K AE N AE D AE G OW0 S
dvärgmus|D V EH RRR Y M UW S
dvärgmås|D V EH RRR Y M OW0 S
dvärgskarv|D V EH RRR Y S K AE RRR V
dvärgspov|D V EH RRR Y S P UW V
dvärgsumphöna|D V EH R Y S UH M P HH OE N AE
dvärgsångare|D V EH RRR Y S AO NG AE RRR EH
dygna|D NG N AE
dyr|D Y UW1 RRR
dysfori|D Y UW1 S F UW RRR IY
dysterkvist|D S T EH RRR K V IH S T
däka|D EH K AE
där|D EH RRR
då|D OW0
dålig|D OW0 L IH G
dö|D OE
död|D OE D
döda|D OE D AE
dödprat|D OE D P RRR AA T
dölja|D ER L Y AE
e|EH
ed|EH0 D
edvin|EH0 D V IH N
efor|EH0 F OW0 RRR
efter|EH F T EH RRR
eftersom|EH F T AE RRR S AO M
egentlig|EH Y EH NG K L IH G
egentligen|IH Y EH NG K L IH G EH N
egg|EH G
egga|EH G AE
egypten|EH Y P T EH N
einsteinium|AE Y N S T AE Y N IH UH M
ek|EH0 K
ekmes|EH0 K M EH0 S
eko|EH0 K UH
ekollon|EH0 K AO L AO N
eksångare|EH0 K S AO NG AE RRR EH
el|EH0 L
elak|EH0 L AA K
elcykel|EH0 L S K EH L
eld|EH L D
eldar|EH L D AE RRR
eldslandet|EH L D S L AE N D EH T
elefanta|EH L EH F AE N T AE
elegant|EH L EH G AE N T
elektron|EH L EH K T RRR OW0 N
eleonorafalk|EH L EH AO N OW0 RRR AE F AE L K
elfte|EH L F T EH
eller|EH L EH RRR
elva|EH L V AE
emigrant|EH M IH G RRR AE N T
emulera|EH M UH L EH0 RRR AE
en|EH NG
enastående|EH0 N AE S T OW0 EH N D EH
enda|EH N D AE
energi|EH N AH0 RRR IY
enfaldig|EH0 N F AE L D IH G
engagemang|AE NG G AE EH M AE NG
engagera|AE NG G AE EH0 RRR AE
engelska|EH0 NG EH0 L S K AE
england|EH NG L AA N D
enhetlig|EH0 N HH EH0 T L IH G
enkel|EH NG K EH L
enkelbeckasin|EH N K EH L B EH K AE S IY N
ensam|EH N S AE M
ensamhet|EH N S AE M HH EH0 T
entrecôte|AE NG T RRR EH K OW0 T
entré|AE NG T RRR EH0
entusiasm|EH N T UH S IH AE S M
er|EH0 RRR
era|EH0 RRR AE
erbium|EH RRR B IH UH M
erinra|EH0 RRR IH N RRR AE
erkänna|EH0 RRR SH EH N AE
erkänt|EH RRR SH EH N T
errata|EH RRR AA T AE
eskilstuna|EH S K IH L S T UW N AE
esperanto|EH S P AH0 RRR AE N T UH
estniska|EH S T N IH S K AE
ett|EH T
euro|EH RRR UH
europa|EH RRR UW P AE
europium|EH RRR UW P IH UH M
europé|EH RRR UH P EH0
eva|EH0 V AE
evelina|EH V EH L IY N AE
event|EH V EH N T
excel|EH K S EH L
experiment|EH K S P EH RRR IH M EH N T
fabrik|F AE B RRR IY K
fackverk|F AE K V EH RRR K
fader|F AA D EH RRR
falang|F AE L AE NG
falla|F AE L AE
fallskärm|F AE L EH RRR M
falsk|F AE L S K
fan|F EH N
far|F AA RRR
farlig|F AA RRR L IH G
fars|F AA RRR S
fartkamera|F AA T K AA M EH RRR AE
farväl|F AA RRR V EH L
fatabur|F AA T AE B UW RRR
fattig|F AE T IH G
februari|F EH B RRR UH AA RRR IH
fejs|F EH Y S
fem|F EH M
femtal|F EH M T AA L
femte|F EH M T EH
femtio|F EH M T IH UH
femtiöring|F EH M T IH ER RRR IH NG
femton|F EH M T AO N
fena|F EH0 N AE
fest|F EH S T
fet|F EH0 T
fett|F EH T
fia|F IY AE
ficka|F IH K AE
fiende|F IY EH N D EH
fientlig|F IH EH N T L IH G
figur|F IH G UW RRR
fik|F IY K
fika|F IY K AE
fikarast|F IY K AE RRR AE S T
fil|F IY L
filippa|F IH L IH P AE
filippintörnskata|F IH L IH P IY N T OE RRR N S K AA T AE
filmatisera|F IH L M AE T IH S EH0 RRR AE
filmjölk|F IY L M Y ER L K
filosofie|F IH L UH S UH F IY EH
filosofisk|F IH L UH S OW0 F IH S K
fimpa|F IH M P AE
fin|F IY N
final|F IH N AA L
finger|F IH NG EH RRR
fingers|F IH NG EH RRR S
finland|F IH N L AE N D
finna|F IH N AE
finnjävel|F IH N Y EH V EH L
finska|F IH N S K AE
firre|F IH RRR EH
fisk|F IH S K
fiske|F IH S K EH
fisken|F IH S K EH N
fiskens|F IH S K EH N S
fisktärna|F IH S K T UH1 RRR N AE
fission|F IH UW N
fitta|F IH T AE
fittig|F IH T IH G
fjantig|F Y AE N T IH G
fjol|F Y UW L
fjompig|F Y AO M P IH G
fjor|F Y UW RRR
fjord|F Y UW RRR D
fjortis|F Y UW T IH S
fjorton|F Y UH T AO N
fjällabb|F Y EH L L AE B
fjällgås|F Y EH L G OW0 S
fjällpipare|F Y EH L P IY P AE R EH
fjällripa|F Y EH L R IY P AE
fjälluggla|F Y EH L UH G L AE
fjärd|F Y AE D
fjärde|F Y EH RRR D EH
fjäril|F Y EH RRR IH L
fjärt|F Y AE T
flarra|F L AE RRR AE
flata|F L AA T AE
fleece|F L IY S
flicka|F L IH K AE
flickan|F L IH K AE N
flickor|F L IH K UH RRR
flod|F L UW D
flodvåg|F L UW D V OW0 G
flottningsmärke|F L AO T N IH NG S M EH RRR K EH
flummig|F L UH M IH G
fluor|F L OW0 RRR
flygskam|F L Y UW1 G S K AE M
flyktig|F L K T IH G
flyta|F L Y UW1 T AE
flytta|F L T AE
fläckdrillsnäppa|F L EH K D RRR IH L S N EH P AE
flå|F L OW0
flår|F L OW0 RRR
flöte|F L OE T EH
focka|F AO K AE
folkmusik|F AO L K M UH S IY K
folköl|F AO L K OE L
fonetik|F AO N EH0 T IY K
formation|F AO RRR M AE UW N
fors|F AO SH
forstmästare|F AO RRR S T M EH S T AE RRR EH
forstväsen|F AO RRR S T V EH S EH N
fort|F UH T
fosfor|F AO S F AO RRR
foster|F UH S T EH RRR
fosterland|F UH S T AE RRR L AE N D
fot|F UW T
fotboll|F UW T B AO L
fotnot|F UW T N UW T
foula|F AE UH L AE
foxtrot|F AO K S T RRR AO T
frakt|F RRR AE K T
fram|F RRR AE M
framför|F RRR AE M F ER RRR
fransk|F RRR AE N S K
franska|F RRR AE N S K AE
fred|F RRR EH0 D
fredag|F RRR EH0 D AA G
fredrika|F RRR EH D RRR IY K AE
freestyle|F R IY S T AE Y L
fri|F RRR IY
frid|F RRR IY D
friggebod|F RRR IH G EH B UW D
frihet|F RRR IY HH EH0 T
fritiof|F RRR IH T SH AO F
fritis|F RRR IY T IH S
fru|F RRR UW
frugge|F RRR UH G EH
frukt|F RRR UH K T
frunch|F RRR UH N
frys|F RRR Y UW1 S
främlingsfientlig|F RRR EH M L IH NG S F IH EH N T L IH G
främlingsfientlighet|F RRR EH M L IH NG S F IH EH N T L IH G HH EH0 T
främmat|F RRR EH M AE T
frände|F RRR EH N D EH
fråga|F RRR OW0 G AE
från|F RRR AO N
frånvaro|F RRR OW0 N V AA RRR UH
frö|F RRR OE
fröjd|F RRR ER Y D
fröken|F RRR OE K EH N
frös|F RRR OE S
fubbick|F UH B IH K
ful|F UW L
full|F UH L
fungera|F UH NG G EH0 RRR AE
funka|F UH NG K AE
funktion|F UH NG K UW N
funktionell|F UH NG K UH N EH L
fur|F UW RRR
furnera|F UH RRR N EH0 RRR AE
fusion|F UH UW N
fusk|F UH S K
futurum|F UH T UW RRR UH M
fy|F Y UW1
fyn|F Y UW1 N
fynd|F N D
fyr|F Y UW1 RRR
fyra|F Y UW1 RRR AE
fyrmänning|F Y UW1 RRR M EH N IH NG
fyrtal|F Y UW1 RRR T AA L
fyrtio|F ER RRR T IH UH
fä|F EH
fäbod|F EH B UW D
fälad|F EH L AA D
fältsångare|F EH L T S AO NG AE RRR EH
fän|F EH N
fänkål|F EH N K OW0 L
fänrik|F EH N RRR IH K
färg|F EH RRR Y
färsk|F EH RRR S K
färskvatten|F EH RRR S K V AE T EH N
fäst|F EH S T
få|F OW0
fågel|F OW0 G EH L
får|F OW0 RRR
fåraherde|F OW0 RRR AE HH EH0 RRR D EH
fårakläder|F OW0 RRR AE K L EH D EH RRR
fåtal|F OW0 T AA L
fåtölj|F UH T ER L Y
föda|F OE D AE
födelsedag|F OE L S EH D AA G
fönster|F ER N S T EH RRR
fönstertittarsjuka|F ER N S T EH RRR T IH T AE RRR UW K AE
för|F OE RRR
förbruka|F ER RRR B RRR UW K AE
förbud|F ER RRR B UW D
förbundskapten|F ER RRR B UH N D S K AE P T EH0 N
förbutik|F OE RRR B UW T IY K
fördriva|F ER RRR D RRR IY V AE
fördöma|F UH RRR D UH M AE
före|F OE RRR EH
förebrå|F OE RRR EH B RRR OW0
föregångare|F OE RRR EH G AO NG AE RRR EH
förena|F ER RRR EH0 N AE
förening|F ER RRR EH0 N IH NG
förete|F OE RRR EH T EH0
förgänglig|F ER RRR Y EH NG L IH G
förgäves|F ER RRR Y EH V EH S
förnuftig|F ER N UH F T IY G
förrän|F ER RRR EH N
försiktighet|F OE RRR S IH K T IH G HH EH0 T
förskolelärare|F OE RRR S K UW L EH L EH RRR AE RRR EH
förskollärare|F OE RRR S K UW L EH L EH RRR AE RRR EH
förskräcklig|F ER RRR S K RRR EH K L IH G
förstå|F ER RRR S T OW0
förstås|F SH T AO S
förstöra|F ER SH T ER RRR AE
försvarare|F OE RRR S V AA RRR AE RRR EH
försvarstal|F ER RRR S V AA RRR S T AA L
försöka|F ER RRR S OE K AE
förträfflig|F ER RRR T RRR EH F L IH G
förut|F ER RRR UW T
förvirring|F OE RRR V IH RRR IH NG
förvärra|F ER RRR V AE RRR AE
förvärras|F ER RRR V AE RRR AE S
förälder|F ER RRR EH L D AE RRR
förälskad|F ER RRR EH L S K AE D
förälskelse|F ER RRR EH L S K EH L S EH
g|
gabbe|G AE B EH
gabriel|G AA B RRR IH EH L
gadd|G AE D
gaffel|G AE F EH L
galax|G AE L AE K S
galär|G AE L EH RRR
gammal|G AE M AE L
gamme|G AE M EH
gammeldans|G AE M EH L D AE N S
gammelgädda|G AE M EH L Y EH D AE
gammelmedia|G AE M EH L M EH0 D IH AE
garage|G AE RRR AA
garanti|G AE RRR AE N T IH
gas|G AA S
gata|G AA T AE
gav|G AA V
ge|Y EH0
gelé|EH L EH0
gem|G EH0 M
gemen|Y EH M EH0 N
gen|Y EH0 N
general|Y EH N EH RRR AA L
generös|EH N EH RRR OE S
genitiv|Y EH0 N IH T IY V
genom|Y EH0 N AO M
genre|AE NG EH RRR
genren|AE NG EH RRR N
genrep|Y EH0 N RRR EH0 P
genrer|AE NG RRR AE RRR
genrerna|AE NG RRR AE RRR N AE
gentil|AE NG T IY L
georg|Y EH0 AO RRR Y
ger|Y EH0 RRR
germanium|Y EH RRR M AA N IH UH M
gert|G AE T
gest|EH S T
get|Y EH0 T
geting|Y EH0 T IH NG
getruta|Y EH0 T RRR UW T AE
geväder|Y EH V EH D EH0 RRR
gevär|Y EH V EH RRR
gick|Y IH K
gifter|Y IH F T EH RRR
giftig|Y IH F T IH G
gin|Y IH N
gipsplatta|Y IH P S P L AE T AE
gipsskiva|Y IH P S IY V AE
gir|Y IY RRR
giraff|IH RRR AE F
gita|Y IY T AE
gitarr|Y IH T AE RRR
gitta|G IH T AE
giva|Y IY V AE
gjord|Y UH D
gjorde|Y UH D EH
gjort|Y UH T
gjuta|Y UW T AE
glad|G L AA D
gladlynt|G L AA D L N T
glas|G L AA S
glashus|G L AA S HH UW S
glasmästarsill|G L AA S M EH S T AE RRR S IH L
glass|G L AE S
glassmaskin|G L AE S M AE IY N
glatt|G L AE T
gluttsnäppa|G L UH T S N EH P AE
glögg|G L ER G
gnag|G N AA G
gned|G N EH0 D
gnid|G N IY D
gnids|G N IY D S
god|G UW D
goddag|G UH D AA G
golv|G AO L V
gott|G AO T
gradu|G RRR AA D UW
gran|G RRR AA N
gransångare|G RRR AA N S AO NG AE RRR EH
grattis|G RRR AE T IH S
gratäng|G RRR AE T EH NG
grav|G RRR AA V
gravand|G R AA V AE N D
gravitation|G RRR AE V IH T AE UW N
gravlax|G RRR AA V L AE K S
green|G RRR IY N
grej|G RRR EH Y
grekland|G RRR EH0 K L AE N D
grep|G RRR EH0 P
grina|G RRR IY N AE
grip|G RRR IY P
groda|G RRR UW D AE
gross|G RRR AO S
grov|G RRR UW V
grund|G RRR UH N D
grym|G RRR M
grymta|G RRR M T AE
gryning|G RRR Y UW1 N IH NG
gryta|G RRR Y UW1 T AE
gräddbulle|G RRR EH D B UH L EH
gräddfil|G RRR EH D F IY L
gräsand|G R EH S AE N D AE N D
grät|G RRR EH T
gråben|G RRR OW0 B EH0 N
grågam|G RRR OW0 G AA M
grågås|G R OW0 G OW0 S
gråhakedopping|G R OW0 HH AA K EH D AO P IH NG
gråhäger|G RRR OW0 HH EH G EH RRR
gråspett|G RRR OW0 S P EH T
gråsäl|G RRR OW0 S EH L
gråt|G RRR OW0 T
gråtrut|G RRR OW0 T RRR UW T
grön|G RRR OE N
grönbena|G RRR OE N B EH0 N AE
grönkål|G RRR OE N K OW0 L
grönsångare|G RRR OE N S AO NG AE RRR EH
gröt|G RRR OE T
gubbe|G UH B EH
gud|G UW D
guding|G UW D IH NG
guds|G UH T S
gul|G UW L
gula|G UW L AE
guld|G UH L D
gullgosse|G UH L G AO S EH
gullviva|G UH L V IY V AE
gump|G UH M P
gungfly|G UH NG F L Y UW1
gurra|G UH RRR AE
guru|G UW RRR UH
guss|G UH Z
gym|Y M
gymma|Y M AE
gymnasium|Y M N AA S IH UH M
gyros|G Y UW1 RRR UH S
gäl|G EH L
gäri|G EH RRR IH
gärna|Y EH RRR N AE
gäst|Y EH S T
gästfri|Y EH S T F RRR IY
gästfrihet|Y EH S T F RRR IY HH EH0 T
gästgiveri|Y AE IH V EH RRR IY
gävle|Y EH V L EH
gå|G OW0
gång|G AO NG
gången|G AO NG EH0 N
gångjärn|G AO NG Y EH RRR N
gård|G OW0 RRR D
gås|G OW0 S
gåskarl|G OW0 S K AA RRR
gåstol|G OW0 S T UW L
gått|G AO T
gök|Y OE K
göktyta|Y OE K T Y UW1 T AE
göl|Y OE L
göra|G ER RRR AE
göran|Y OE RRR AE N
gördel|Y ER RRR D EH L
göt|G OE T
göteborg|Y ER T EH B AO RRR Y
göteborgska|Y ER T EH0 B AO RRR Y S K AE
gött|G ER T
ha|HH AA V AE
hade|HH AE D EH
haft|HH AE F T
hage|HH AA G EH
hagtorn|HH AA G T UW RRR N
haj|HH AE Y
hall|HH AE L
hallon|HH AE L AO N
hallå|HH AE L OW0
halmbock|HH AE L M B AO K
halmstad|HH L M S T AE D
halv|HH AE L V
halvlek|HH AE L V L EH0 K
hambo|HH AE M B UH
han|HH AE N
hand|HH AE N D
handikapp|HH AE N D IY K AE P
handskrift|HH AE N D S K RRR IH F T
handtryck|HH AE N D T RRR K
hans|HH AA N S
hantverk|HH AE N T V EH RRR K
har|HH AA RRR
hara|HH AA RRR AE
hat|HH AA T
hata|HH AA T AE
hatt|HH AE T
hav|HH AA V
havre|HH AA V RRR EH
havssula|HH AE V S UW L AE
havstrut|HH AE V S T RRR UW T
havsörn|HH AE V S OE RRR N
heat|HH IY T
hej|HH EH Y
hekto|HH EH K T UH
hel|HH EH0 L
helg|HH EH L Y
helga|HH EH L G AE
helig|HH EH0 L IH G
helium|HH EH0 L IH UH M
helsingborg|HH EH L S IH NG B AO RRR Y
helsingfors|HH EH L S IH NG F AO RRR S
helsingör|HH EH L S IH NG OE RRR
helvete|HH EH L V EH T EH
hem|HH EH M
hembränd|HH EH M B RRR EH N D
hembränt|HH EH M B RRR EH N T
hemester|HH EH M EH S T EH RRR
hemläxa|HH EH M L EH K S AE
hemmaplan|HH EH M AE P L AA N
hemul|HH EH0 M UW L
hen|HH EH N
henne|HH EH N EH
henom|HH EH N AO M
hens|HH EH N S
herbert|HH AE RRR B AE T
herdestund|HH EH0 RRR D EH S T UH N D
herr|HH EH RRR
herre|HH EH RRR EH
hertz|HH AE RRR T S
het|HH EH0 T
heta|HH EH0 T AE
hetvägg|HH EH0 T V EH G
hia|HH IY AE
hialös|HH IY AE L OE S
himalaya|HH IH M AA L AE Y AE
himalayagyllenmes|HH IY M AA L IH Y AE Y L EH N M EH0 S
hinsidan|HH IH N S IY D AE N
hispa|HH IH S P AE
hispig|HH IH S P IH G
hitta|HH IH T AE
hjord|Y UW D
hjort|Y UH RRR T
hjorta|Y UH RRR T AE
hjortron|Y UH T RRR AO N
hjul|Y UW L
hjälm|Y EH L M
hjälp|Y EH L P
hjälpa|Y EH L P AE
hjälte|Y EH L T EH
hjärna|Y EH N AE
hjärta|Y EH RRR T AE
hjärtinfarkt|Y EH RRR T IH N F AE RRR K T
hjärtlig|Y AE T L IH G
hockeyfrilla|HH AO K F RRR IH L AE
holm|HH AO L M EH
homofili|HH UW M UW F IY L IY
homosex|HH UW M UH S EH0 K S
hon|HH UH N
honom|HH AO N AO M
honung|HH OW0 N UH NG
hoppa|HH AO P AE
hoppeligen|HH AO P EH L IY G EH N
hor|HH UW RRR
hornuggla|HH UH RRR N UH G L AE
horoskop|HH UH RRR UH S K OW0 P
hos|HH UH S
hot|HH UW T
hotell|HH UH T EH L
hov|HH UW V
hud|HH UW D
hudsonspov|HH AA D S AO N S P UW V
huggmejsel|HH UH G M EH Y S EH L
humle|HH UH M L EH
hund|HH UH N D
hundra|HH UH N D RRR AE
hungrig|HH UH NG RRR IH G
hur|HH UW RRR
hurring|HH UH RRR IH NG
hus|HH UW S
husdjur|HH UW S Y UW RRR
husmanskost|HH UW S M AE N S K AO S T
hussvala|HH UW S S V AA L AE
hustru|HH UH S T RRR UW
huv|HH UW V
huvud|HH UW EH
huvudspråk|HH UW V UH D S P RRR OW0 K
hyf|HH Y UW1 F
hygglig|HH G L IH G
hylla|HH L AE
hyperdrift|HH Y UW1 P EH RRR D RRR IH F T
hyrkanmes|HH R K AE N M EH0 S
häftig|HH EH F T IH G
hägna|HH EH NG N AE
häl|HH EH L
häll|HH EH L
hällregn|HH EH L RRR EH NG N
här|HH AE RRR
häradshövding|HH AE RRR AE D S HH ER V D IH NG
häradsrätt|HH AE RRR AE D S RRR EH T
härför|HH AE RRR F OE RRR
härk|HH EH RRR K
härlig|HH EH RRR L IH G
härmsångare|HH EH RRR M S AO NG AE RRR EH
härold|HH EH RRR AO L D
håg|HH OW0 G
håla|HH OW0 L AE
håna|HH OW0 N AE
hår|HH OW0 RRR
hårdrockare|HH OW0 RRR D RRR OW0 K AE RRR EH
hårt|HH OW0 T
håv|HH OW0 V
hö|HH OE
höbal|HH OE B AA L
hög|HH OE G
höga|HH OE G AE
högkvarter|HH OE G K V AE RRR T EH0 RRR
högljudd|HH OE G Y UH D
högljutt|HH OE G Y UH T
högsvenska|HH OE G S V EH N S K AE
högtid|HH ER K T IY D
hök|HH OE K
hölja|HH ER L Y AE
höna|HH OE N AE
höra|HH OE RRR AE
höst|HH ER S T
höstas|HH ER S T AE S
höstdagjämning|HH ER S T D AA G Y EH M N IH NG
i|IH
idissla|IY D IH S L AE
idrott|IY D RRR AO T
igelkott|IY G EH L K AO T
igenom|IH Y EH0 N AO M
ignorera|IH NG N UH RRR EH0 RRR AE
ihjäl|IH Y EH L
ihop|IH HH UW P
ikea|IH K AE
illamående|IH L AE M OW0 EH N D EH
illusion|IH L UH UW N
imperfekt|IH M P EH RRR F EH K T
in|IH N
inandning|IH N AE N D N IH NG
inbjudan|IH N B Y UW D AE N
indian|IH N D IH AA N
infinitiv|IH N F IH N IH T IY V
inga|IH NG AE
ingendera|IH NG EH N D EH0 RRR AE
ingenjör|IH N EH N Y OE RRR
ingenting|IH NG EH N T IH NG
inger|IH N Y EH0 RRR
inkapabel|IH N K AE P AA B EH L
inn|IH N
innan|IH N AE N
innanför|IH N AE N F OE RRR
insexnyckel|IH N S EH K S N K EH L
insjukna|IH N UW K N AE
inspektion|IH N S P EH K UW N
instruktion|IH N S T RRR UH K UW N
inte|IH N T EH
integral|IH N T EH G RRR AE L
internationell|IH N T EH RRR N AE T UH N EH L
internet|IH N T EH RRR N EH T
intervju|IH N T EH RRR V Y UW
intryck|IH N T RRR K
intyg|IH N T Y UW1 G
invändig|IH N V EH N D IH G
iriomotemes|IH R IH Y AO M AO T EH M EH0 S
irland|IH RRR L AE N D
irra|IH RRR AE
is|IY S
isabella|IH S AE B EH L AE
isabellatörnskata|IH S AE B EH L AE T OE RRR N S K AA T AE
ismås|IY S M OW0 S
israel|IH S RRR AE EH0 L
italien|IH T AO L IH AH0 N
ivar|IY V AE RRR
j|
ja|Y AA
jacka|Y AE K AE
jacke|Y AE K EH
jag|Y AA G
jaga|Y AA G AE
jak|Y AA K
jaktfalk|Y AE K T F AE L K
jalla|Y AE L L AE
jalusi|AE L UH S IY
jam|Y AA M
januari|Y AE N UH AA RRR IH
japan|Y AA P AE N
japanare|Y AE P AA N AE RRR EH
japansk|Y AE P AA N S K
japanska|Y AE P AA N S K AE
jargong|AE RRR G AO NG
jasmine|AE S M IY N
jason|Y AA S AO N
jennie|Y EH N IH
jenny|Y EH N
jerusalem|Y EH RRR UW S AE L EH M
jesuit|Y EH S UW IY T
jesus|Y EH0 S UH S
jiddra|Y IH D RRR AE
jo|Y UW
jocke|Y UH K EH
jod|Y AO D
johan|Y UH AE N
johanna|Y UH HH AE N AE
joint|Y AO IH N T
jojk|Y AO Y K
jojka|Y AO Y K AE
jojo|Y UH Y UH
jokk|Y AO K
jolle|Y AO L EH
jonas|Y UW N AE S
jonsson|Y UH N S AO N
jonte|Y AO N T EH
joppe|Y AO P EH0
jord|Y UW RRR D
jordafärd|Y UW RRR D AE F EH RRR D
jorden|Y UW RRR D EH N
jordgubbe|Y UW D G UH B EH
jorduggla|Y UH RRR D UH G L AE
jordvarg|Y UW D V AE RRR Y
jota|Y UW T AE
journal|UH N AA L
journalist|UH RRR N AE L IH S T
jox|Y UH K S
ju|Y UW
judetyska|Y UW D EH T S K AE
juice|Y UW S
jul|Y UW L
julas|Y UW L AE S
julgranskula|Y UW L G RRR AA N S K UW L AE
juli|Y UW L IH
julmust|Y UW L M UH S T
jungfrukälla|Y UW NG F RRR UW SH EH L AE
jungfrutrana|Y UH NG F R UH T R AA N AE
juni|Y UW N IH
jupiter|Y UW P IH T EH RRR
jury|Y UH RRR
juver|Y UW V EH RRR
jägmästare|Y EH G M EH S T AE RRR EH
jämte|Y EH M T EH
järn|Y EH RRR N
järnvägsstation|Y AE N V EH G S S T AE UW N
järpe|Y EH R P EH
järv|Y AE RRR V
jäst|Y EH S T
jävel|Y EH V EH L
jävig|Y EH V IH G
jönköping|Y UH1 N T SH UH1 P IH NG
k|SH
kackig|K AE K IH G
kadmium|K AE D M IH UH M
kaffe|K AE F EH
kaffegök|K AE F EH0 Y OE K
kaffepumla|K AE F EH P UH M L AE
kafé|K AE F EH0
kajak|K AE Y AA K
kaka|K AA K AE
kakao|K AA K AE UH
kal|K AA L
kalabalik|K AE L AE B AE L IY K
kalcium|K AE L S IH UH M
kalifornien|K AE L IH F UW RRR N IH EH N
kalium|K AA L IH UH M
kalk|K AE L K
kalkon|K AE L K UW N
kall|K AE L
kalla|K AE L AE
kalle|K AE L EH
kallprat|K AE L P RRR AA T
kalmarit|K AE L M AE RRR IY T
kam|K AE M
kamera|K AA M EH RRR AE
kan|K AE N
kanadagås|K AE N AE D AE G OW0 S
kanadames|K AE N AE D AE M EH0 S
kanadensisk|K AE N AE D EH N S IH S K
kanelbulle|K AE N EH0 L B UH L EH
kanelsnäcka|K AE N EH0 L S N EH K AE
kanot|K AE N UW T
kanske|K AE N EH
kaos|K AA UH S
kapmes|K AA P M EH0 S
kappa|K AE P AE
kar|K AA RRR
karbin|K AE RRR B IY N
kardinal|K AE D IH N AO L
karina|K AE RRR IY N AE
karl|K AA RRR L
karolina|K AE RRR UH L IY N AE
karolinasumphöna|K AE R UH L IY N AE S UH M P HH OE N AE
karolinatita|K AE R UH L IY N AE T IY T AE
karta|K AA RRR T AE
kasse|K AE S EH
kasus|K AA S UH S
katarina|K AE T AE RRR IY N AE
katod|K AE T UW D
katrina|K AE T RRR IY N AE
katt|K AE T
kedja|SH EH D Y AE
keff|K EH F
kejsarörn|SH EH Y S AE RRR OE RRR N
kemi|SH EH M IY
keramik|SH EH RRR AE M IY K
kerstin|SH AE SH T IH N
ketchup|K EH T SH UH P
kex|SH EH K S
kidnappa|K IY D N AE P AE
kika|SH IY K AE
kil|SH IY L
kille|SH IH L EH
kilo|SH IY L UH
kilometer|SH IH L UH M EH0 T EH RRR
kina|SH IY N AE
kind|SH IH N D
kinders|SH IH N D EH RRR S
kines|SH IH N EH0 S
kinesa|SH IH N EH0 S AE
kinesisk|SH IH N EH0 S IH S K
kinesiska|SH IH N EH0 S IH S K AE
kiosk|SH AO S K
kioskmongo|SH AO S K M AO NG G UH
kioskvältare|SH OW0 S K V EH L T AE RRR EH
kirra|K IH RRR AE
kirurg|SH IH RRR UH RRR G
kis|HH IY S
kisel|SH IY S EH L
kiss|K IH S
kissa|K IH S AE
kista|SH IH S T AE
kitsch|K IH T
kitschig|K IH T IH G
kittel|SH IH T EH L
kjell|SH EH L
kjellberg|SH EH L B AE RRR Y
kjol|SH UW L
kladdkaka|K L AE D K AA K AE
klandra|K L AE N D RRR AE
klar|K L AA RRR
klarhet|K L AA RRR HH EH0 T
klinga|K L IH NG AE
klingonska|K L IH NG AO N S K AE
klintbergare|K L IY N T B EH RRR Y AE RRR EH0
klippduva|K L IH P D UW V AE
klippkaja|K L IH P K AE Y AE
klippsvala|K L IH P S V AA L AE
klittra|K L IH T RRR AE
klocka|K L AO K AE
klon|K L UW N
klonken|K L AO NG K EH N
klor|K L UW RRR
kläde|K L EH D EH
kläder|K L EH D EH RRR
klädhängare|K L EH D HH EH NG AE RRR EH
klå|K L OW0
klår|K L OW0 RRR
klökas|K L OE K AE S
klösa|K L OE S AE
klövdjur|K L OE V Y UW RRR
knaffel|K N AE F EH L
knapp|K N AE P
knappologi|K N AE P UH L UH G IY
knark|K N AE RRR K
knarka|K N AE RRR K AE
kned|K N EH0 D
kniv|K N IY V
knoparmoj|K N UW P AE RRR M AO Y
knubbsäl|K N UH B S EH L
knulla|K N UH L AE
knut|K N UW T
knuten|K N UW T EH N
knä|K N EH
knåda|K N OW0 D AE
knô|K N ER
knö|K N ER
knöl|K N OE L
knölsvan|K N OE L S V AA N
knölsvärta|K N OE L S V EH T AE
ko|K UW
kobolt|K UW B AO L T
koboltmes|K UW B AO L T M EH0 S
kod|K UW D
kofta|K AO F T AE
kol|K OW0 L
kolla|K AO L AE
kolymasnäppa|K AO L Y UW1 M AE S N EH P AE
kom|K AO M
komma|K AO M AE
kommer|K AO M EH RRR
kompis|K AO M P IH S
komplett|K AO M P L EH T
kon|K UW N
kondition|K AO N D IH UW N
konflikt|K AO N F L IH K T
konspiration|K AO N S P IH RRR AE UW N
konspirationsteoretiker|K AO N S P IH RRR AE UW N S T EH UH RRR EH0 T IH K EH RRR
konspirationsteori|K AO N S P IH RRR AE UW N S T EH UH RRR IY
konst|K AO N S T
konstbefrukta|K AO N S T B EH F RRR UH K T AE
konstbevattna|K AO N S T B EH V AE T N AE
konstbevattning|K AO N S T B EH V AE T N IH NG
konstfiber|K AO N S T F IY B EH RRR
konstgjord|K AO N S T Y UH RRR D
konstläder|K AO N S T L EH D EH RRR
konstruktion|K AO N S T RRR UH K UW N
konsumtion|K AO N S UH M UW N
kontra|K AO N T RRR AE
kontrast|K UH N T RRR AE S T
konung|K OW0 N UH NG
konungarike|K OW0 N UH NG AE RRR IY K EH
kopia|K UH P IY AE
kopp|K AO P
koppar|K AO P AE RRR
kopparand|K AO P AE R AE N D
koppling|K AO P L IH NG
kopplingskåpa|K AO P L IH NG S K OW0 P AE
kor|K UW RRR
korea|K UH RRR EH0 AE
korean|K UH RRR EH0 AE N
korg|K AO RRR Y
kornknarr|K UW N K N AE R
korp|K AO RRR P
korshänvisning|K AO RRR S HH EH N V IY S N IH NG
kort|K UH RRR T
korttålärka|K AO RRR T OW0 L EH RRR K AE
kost|K AO S T
kostpris|K AO S T P RRR IY S
koxik|K UH K S IH K
koyot|K UH Y OW0 T
krabba|K RRR AE B AE
krabbis|K RRR AA B IY S
kraftfull|K RRR AE F T F UH L
kragtrapp|K R AA G T R AE P
kran|K RRR AA N
krans|K RRR AA N S
krav|K R AA V
kretensisk|K RRR EH T EH N S IH S K
kretsschema|K RRR EH T S EH0 M AE
krig|K RRR IY G
kristianstad|K RRR IH AE N S T AE
kristina|K RRR IH S T IY N AE
krita|K RRR IY T AE
krog|K RRR UW G
krokan|K RRR UH K AA N
krokben|K RRR UW K B EH0 N
krom|K RRR OW0 M
krona|K RRR UW N AE
kronor|K RRR UW N UH RRR
kropp|K RRR AO P
kruka|K RRR UW K AE
krusbär|K RRR UW S B EH RRR
krut|K RRR UW T
kräftskiva|K RRR EH F T IY V AE
kröka|K RRR OE K AE
kuba|K UW B AE
kudde|K UH D D EH
kuf|K UW F
kuk|K UW K
kuksugare|K UW K S UW G AE RRR EH
kul|K UW L
kuling|K UW L IH NG
kull|K UH L
kulör|K UH L OE RRR
kunde|K UH N D AH0
kung|K UH NG
kungsfiskare|K UH NG S F IH S K AE RRR EH
kungsfågel|K UH NG S F OW0 G EH L
kungsfågelsångare|K UH NG S F OW0 G EH L S AO NG AE RRR EH
kunna|K UH N AE
kur|K UW RRR
kurr|K UH RRR
kurs|K UW RRR S
kuse|K UW S EH
kusin|K UH S IY N
kustlabb|K UH S T L AE B
kustpipare|K UH S T P IY P AE R EH
kustsnäppa|K UH S T S N EH P AE
kut|K UW T
kuta|K UW T AE
kuttrasju|K UH T RRR AE UW
kuvert|K UH V EH RRR
kvalitet|K V AE L IH T EH0
kvar|K V AA RRR
kvarg|K V AE RRR Y
kvart|K V AA RRR T
kvarter|K V AE RRR T EH0 RRR
kvasar|K V AE S AA RRR
kvicksilver|K V IH K S IH L V EH RRR
kvinna|K V IH N AE
kvinnan|K V IH N AE N
kvinnor|K V IH N UH RRR
kvist|K V IH S T
kvitta|K V IH T AE
kvälja|K V EH L Y AE
kväll|K V EH L
kvänska|K V EH N S K AE
kväve|K V EH V EH
kyckling|SH K L IH NG
kyrka|SH RRR K AE
kysk|SH S K
kyskhet|SH S K HH EH0 T
kyss|SH S
kyssa|SH S AE
käck|SH EH K
käftis|SH EH F T IH S
käk|SH EH K
käka|SH EH K AE
käke|SH EH K EH
källa|SH EH L AE
källare|SH EH L AE RRR EH
källing|SH EH L IH NG
känd|SH EH N D
känga|SH EH NG AE
känguru|SH EH NG G UH RRR UH
känna|SH EH N N AE
kännspak|SH EH N S P AA K
känsla|SH EH N S L AE
känt|SH EH N T
käpp|SH EH P
kär|SH EH RRR
kära|SH EH RRR AE
kärl|SH EH RRR L
kärlek|SH EH RRR L EH0 K
kärrhök|SH EH RRR HH OE K
kärrsnäppa|SH EH RRR S N EH P AE
kärrsångare|SH EH RRR S AO NG AE RRR EH
kärrtärna|SH EH RRR T UH1 RRR N AE
kå|K OW0
kåda|K OW0 D AE
kåk|K OW0 K
kål|K OW0 L
kålrabbi|K OW0 L RRR AE B IH
kår|K OW0 RRR
kåt|K OW0 T
kåta|K OW0 T AE
kö|K OE
köa|K OE AE
kök|SH OE K
kökkenmödding|K ER K EH N M ER D IH NG
köl|SH OE L
kölna|SH OE L N AE
kön|SH OE N
köp|SH OE P
köpa|SH OE P AE
köpenhamn|SH OE P EH N HH AE M N
köpstad|SH OE P S T AA D
kör|SH ER RRR
köra|SH ER RRR AE
körandas|K OE RRR AE N D AE S
körandning|K OE RRR AE N D N IH NG
kött|SH ER T
köttbullar|SH ER T B UH L AE RRR
köttbulle|SH ER T B UH L EH
köttig|SH ER T IH G
köttslig|SH ER T S L IH G
la|L AA
laboratorium|L AE B UH RRR AE T UW RRR IH UH M
lade|L AA D EH
ladugård|L AA D UH G OW0 RRR D
lag|L AA G
lager|L AA G EH RRR
lagom|L AA G AO M
lagt|L AE K T
lagts|L AE K T S
lagård|L AA G AO D
laja|L AE Y AE
lajbans|L AE Y B AE N S
lakan|AA K AE N
lakrits|L AA K RRR IH S
lamm|L AE M
lammgam|L AE M G AA M
lammkött|L AE M SH ER T
land|L AE N D
landkrabba|L AE N D K RRR AE B AE
landskapsdjur|L AE N D S K AA P S Y UW RRR
landskronit|L AE N D S K RRR UH N IY T
lantbrevbärare|L AE N T B RRR EH0 V B EH RRR AE RRR EH
lanterna|L AE N T AE N AE
lappmes|L AE P M EH0 S
lappuggla|L AE P UH G L AE
larv|L AE RRR V
lasagne|L AE S AE N Y
lastförskjutningsnät|L AE S T F OE RRR UW T N IH NG S N EH T
lattja|L AE T SH AE
lattjo|L AE T SH UH
lavoar|L AE V W AE RH
lavskrika|L AA V S K RRR IY K AE
lax|L AE K S
layout|L EH Y AE UH T
le|L EH0
lealös|L EH0 AE L OE S
leddjur|L EH0 D Y UW RRR
ledig|L EH0 D IH G
ledsen|L EH S AH0 N
ledsna|L EH S N AE
leende|L EH0 EH N D EH
legend|L EH0 G EH0 N D
legitim|L EH G IH T IY M
lego|L EH0 G UW
leidenflaska|L EH Y D EH N F L AE S K AE
leif|L EH Y F
lemur|L EH M UW RRR
lesbisk|L EH S B IH S K
less|L EH S
lettiska|L EH T IH S K AE
lev|L EH0 V
leva|L EH0 V AE
leverpastej|L EH0 V EH RRR P AE S T EH Y
lian|L IY AE N
lie|L IY EH
lik|L IY K
liksom|L IH K S AO M
lillejulafton|L IH L EH Y UW L AE F T AO N
lima|L IY M AE
lin|L IY N
lina|L IY N AE
lindgren|L IH NG G RRR EH0 N
lingon|L IH NG AO N
lingonsylt|L IH NG AO N S L T
linnea|L IH N EH0 AE
linnéa|L IH N EH0 AE
lisa|L IY S AE
lisas|L IY S AE S
lita|L IY T AE
litauiska|L IH T AE UH IH S K AE
liten|L IY T EH N
litium|L IY T S IH UH M
liv|L IY V
livsfientlig|L IY V S F IH EH N T L IH G
livskvalitet|L IY V S K V AE L IY T EH0 T
ljud|Y UW D
ljuga|Y UW G AE
ljungby|Y UH NG B
ljungpipare|Y UH NG P IY P AE R EH
ljus|Y UW S
ljushyllt|Y UW S HH L T
lo|L UW
lob|L AO B
lodjur|L UW Y UW RRR
loge|L UW G EH
lom|L UH M
london|L AO N D AO N
lopp|L AO P
lounge|L AE UH N D SH
lounges|L UW UH NG EH S
lov|L UW V
lucia|L UH S IY AE
luden|L UW D EH N
lugn|L UH NG N
lunch|L UH N
lunchdisco|L UH D IH S K UH
lunchrast|L UH N RRR AE S T
lund|L UH N D
lundensisk|L UH N D EH N S IH S K
lundgren|L UH N D G RRR EH0 N
lundsångare|L UH N D S AO NG AE RRR EH
lungödem|L UH NG OE D EH0 M
lussekatt|L UH S EH K AE T
lycka|L K AE
lycklig|L K L IH G
lyckt|L K T
lyckta|L K T AE
lydnad|L Y UW1 D N AE D
lykta|L K T AE
lymfocyt|L M F UH S Y UW1 T
lyssna|L S N AE
lyxhotell|L K S HH UH T EH L
läcka|L EH K AE
läder|L EH D EH RRR
läger|L EH G EH RRR
lägga|L EH G AE
län|L EH N
länge|L EH NG EH
längs|L EH NG S
lär|L EH RRR
lära|L AE RRR AE
läs|L EH S
läsa|L EH S AE
läser|L EH S EH RRR
läsesal|L EH S EH S AA L
läsk|L EH S K
läska|L EH S K AE
läsuttal|L EH S UW T T AA L
lätt|L EH T
lätting|L EH T IH NG
låg|L OW0 G
långsam|L AO NG S AE M
långt|L AO NG T
långtåsnäppa|L AO NG T OW0 S N EH P AE
långvarig|L AO NG V AA RRR IH G
låt|L OW0 T
låta|L OW0 T AE
lögn|L ER NG N
lök|L OE K
lön|L OE N
löneslav|L OE N EH S L AA V
lönndom|L ER N D UH M
löpa|L OE P AE
lördag|L OE RRR D AA G
lös|L OE S
lösa|L OE S AE
lösen|L OE S EH N
lövverk|L OE V V EH RRR K
mack|M AE K
macka|M AE K AE
mage|M AA G EH
magnesium|M AE NG N EH0 S IH UH M
magnoliaskogssångare|M AE G N UW L IH Y AE S G UH G S AO NG AE R EH
magnus|M AE NG N UH S
maj|M AE Y
majoritet|M AE Y OW0 RRR IH T EH0 T
maka|M AA K AE
make|M AA K EH
mal|M AA L
malaria|M AE L AA RRR IH AE
malin|M AE L IH N
mall|M AE L
mallis|M AE L IH S
malmö|M AE L M OE
malmöit|M AE L M OE IY T
malte|M AE L T EH
malört|M AA L ER RRR T
mambo|M AE M B UW
mamsell|M AE M Z EH L
man|M AA N
mandrom|M AE N D RRR AO M
manen|M AA N AH0 N
manet|M AE N EH0 T
manga|M AE NG G AE
mangan|M AE NG G AA N
mango|M AE NG G UH
manick|M AE N IH K
mannen|M AE N EH N
manöver|M AE N OE V EH RRR
margareta|M AE RRR G AE RRR EH0 T AE
margarin|M AE RRR G AE RRR IY N
maria|M AE RRR IY AE
marika|M AE RRR IY K AE
mark|M AE RRR K EH RRR
marknaden|M AE RRR K N AE N
mars|M AE SH
marsch|M AE RRR SH
masa|M AA S AE
maskin|M AE IY N
maskros|M AE S K RRR UW S
masktörnskata|M AE S K T OE RRR N S K AA T AE
massa|M AE S AE
massage|M AE S AA
mat|M AA T
matcha|M AE T SH AE
matchfixning|M AE T F IH K S N IH NG
matematik|M AE T EH M AE T IY K
matsäck|M AA T S EH K
matt|M AE T
mattant|M AA T T AE N T
mattias|M AE T IY AE S
meckig|M EH0 K IH G
med|M EH D
medarbetare|M EH0 D AE RRR B EH0 T AE RRR EH
meddela|M EH0 D D EH0 L AE
meddelande|M EH0 D D EH0 L AE N D EH
medelhavstrut|M EH0 D EH L HH AE V S T RRR UW T
medhjälpare|M EH0 D Y EH L P AE RRR EH0
medicin|M EH D IH S IY N
megafon|M EH G AE F OW0 N
mejsel|M EH Y S EH L
mem|M EH0 M
men|M EH N
meningslös|M EH0 N IH NG S L OE S
meningslösa|M EH0 N IH NG S L OE S AE
mens|M EH N S
mentalesiska|M EH N T AE L EH0 S IH S K AE
meny|M EH N Y UW1
mer|M EH0 RRR
merkurius|M EH RRR K UW RRR IH UH S
mes|M EH0 S
messmör|M EH S S M OE RRR
metan|M EH T AA N
meter|M EH0 T EH RRR
metonym|M EH T UH N Y UW1 M
meänkieli|M EH0 EH N K IH EH L IH
middag|M IH D AA G
midsommar|M IH S AO M AE RRR
mig|M EH Y
mikael|M IY K AE EH0 L
miklagård|M IY K L AE G OW0 RRR D
mil|M IY L
mildra|M IH L D RRR AE
miljard|M IH L Y AA D
miljon|M IH L Y UW N
miljö|M IH L Y OE
millimeter|M IH L IH M EH0 T EH RRR
min|M IY N
mina|M IY N AE
mineral|M IY N EH RRR AE L
minikjol|M IY N IH SH UW L
ministerstyre|M IH N IH S T EH RRR S T Y UW1 RRR EH
minnesgod|M IH N EH S G UW D
miombomes|M IH Y AO M B AO M EH0 S
missbrukare|M IH S B RRR UW K AE RRR EH
mission|M IH UW N
mitt|M IH T
mittemot|M IH T EH0 M UW T
mjöd|M Y OE D
mjölk|M Y ER L K
mod|M UW D
mode|M UW D EH
modevisning|M UW D EH V IY S N IH NG
mojäng|M UH Y EH NG
moll|M AO L
moln|M AO L N
molybden|M AO L B D EH0 N
monaco|M AO N AE K UH
mongo|M AO NG G UH
mongolpipare|M AO NG G UH L P IY P AE R EH
monoteist|M AO N UH T EH IH S T
monument|M OW0 N UH M EH N T
mor|M UW RRR
morbror|M UH RRR B RRR UH RRR
mord|M UW D
morgnar|M OW0 RRR N AE RRR
morgnarna|M OW0 N AE N AE
morgon|M AO RRR G AO N
morkulla|M UW RRR K UH L AE
mors|M AO RRR S
morsa|M UH SH AE
morse|M AO RRR S EH0
morsning|M AO RRR S N IH NG
mos|M UW S
moscha|M AO SH AE
moskva|M UH S K V AA
mosnäppa|M UW S N EH P AE
moster|M UH S T EH RRR
mot|M UW T
motgift|M UW T Y IY F T
motion|M UH T UW N
motorcykelhjälm|M UW T AO RRR S K EH L Y EH L M
motsade|M UW T S AA D EH
muck|M UH K
mujka|M UW Y K AA
mula|M UW L AE
mull|M UH L
mumie|M UW M IH EH
mumrik|M UH M RRR IH K
mun|M UH N
mundiarré|M UH N D IH AE RRR EH0
mur|M UW RRR
murpelare|M UW RRR P EH0 L AE RRR EH0
mus|M UW S
museer|M UH S EH0 EH RRR
museum|M UH S EH0 UH M
musik|M UW S IY K
muskedunder|M UH S K EH D UH N D EH RRR
muslim|M UH S L IY M
musseron|M UH S EH RRR AO N
must|M UH S T
mycket|M K EH T
mygga|M G AE
myla|M Y UW1 L AE
mynning|M N IH NG
mynt|M N T
myrsnäppa|M Y UW1 RRR S N EH P AE
myrspov|M Y UW1 RRR S P UW V
mys|M Y UW1 S
mysa|M Y UW1 S AE
mysig|M Y UW1 S IH G
mystisk|M S T IH S K
myt|M Y UW1 T
mäkla|M EH K L AE
mäktig|M EH K T IH G
män|M EH N
människa|M EH N IH AE
mänsklig|M EH N S K L IH G
märklig|M AE RRR K L IH G
mästare|M EH S T AE RRR EH
mäster|M EH S T EH RRR
mästerskap|M EH S T EH0 RRR S K AA P
mäta|M EH T AE
må|M OW0
mål|M OW0 L
måla|M OW0 L AE
månad|M OW0 N AE D
måndag|M AO N D AA G
måne|M OW0 N EH
mångata|M OW0 NG G AA T AE
månsing|M AO N S IH NG
mårka|M AO RRR K AE
mårtensgås|M AO RRR T EH N G OW0 S
måttbestämd|M AO T B EH S T EH M D
mö|M OE
mög|M OE G
mögel|M ER G EH L
möjlig|M ER Y L IH G
mölla|M ER L AE
möp|M OE P
mörk|M UH RRR K
mörker|M UH RRR K EH RRR
mörkna|M UH RRR K N AE
mötesplats|M OE T EH S P L AE T S
nacka|N AE K AE
nackskinn|N AE K IH N
nafs|N AE F S
nagel|N AA G EH L
naiv|N AE IY V
namn|N AE M N
nasa|N AA S AE
nasare|N AA S AE RRR EH
nation|N AE T UW N
nationalist|N AE T UH N AE L IH S T
nationell|N AE T UH N EH L
nato|N AA T UH
natrium|N AA T RRR IH UH M
natt|N AE T
natthäger|N AE T HH EH G EH RRR
ned|N EH0 D
neder|N EH0 D EH RRR
nederländerna|N EH0 D EH RRR L EH N D EH N IY0 AE
nedladdning|N EH0 D L AE D N IH NG
nej|N EH Y
nektarin|N EH K T AE RRR IY N
nellie|N EH L IH
nelly|N EH L
neodym|N EH0 UH D Y UW1 M
neon|N EH OW0 N
nepalesisk|N EH P AE L EH0 S IH S K
neptunium|N EH P T UW N IH UH M
neptunus|N EH P T UW N UH S
ner|N EH0 RRR
neutral|N EH0 UH T RRR AA L
neutron|N EH0 UH T RRR OW0 N
ni|N IY
nicke|N IH K EH
niger|N IY G EH RRR
nigeria|N IH G EH0 RRR IH AE
nigger|N IH G EH0 RRR
nilgås|N IY L G OW0 S
nim|N IH M
nimma|N IH M AE
nio|N IY UH
nionde|N IY AO N D EH
nittio|N IH T IH UH
nitton|N IH T AO N
nja|N Y AA
njalla|N Y AE L AE
njure|N Y UW RRR EH
njut|N Y UW T
njuta|N Y UW T AE
njöt|N Y OE T
nobba|N AO B AE
nobben|N AO B EH N
nobel|N UH B EH L
noll|N AO L
nominativ|N UH M IH N AE T IY V
nord|N UW D
nordbo|N UW RRR D B UW
nordkorea|N UW D K UH RRR EH0 AE
nordsångare|N UW RRR D S AO NG AE RRR EH
norge|N AO RRR Y EH
norr|N AO RRR
norrköping|N AO RRR SH OE P IH NG
norrmalmstorgssyndrom|N AO RRR M AE L M S T AO RRR Y S S N D RRR OW0 M
norska|N AO SH K AE
not|N UW T
november|N UH V EH M B EH RRR
nu|N UW
nummer|N UH M EH RRR
nunatak|N UW N AE T AE K
nusvenska|N UW S V EH N S K AE
ny|N Y UW1
nya|N Y UW1 AE
nyckel|N K EH L
nying|N Y UW1 IH NG
nypa|N Y UW1 P AE
nypon|N Y UW1 P AO N
nyps|N P S
nyss|N S
nyttig|N T IH G
nytänkande|N Y UW1 T EH NG K AE N D EH0
nä|N EH
näbbdjur|N EH B Y UW RRR
näckros|N EH K RRR UW S
nämen|N EH M EH N
nännas|N EH N AE S
näsa|N EH S AE
nästkusin|N EH S T K UH S IY N
nätter|N EH T AH0 RRR
nå|N OW0
någon|N AO N
något|N AO T
några|N OW0 G RRR AE
nål|N OW0 L
nålginst|N OW0 L G IH N S T
nåt|N AO T
nått|N AO T
nödrim|N OE D RRR IH M
nödvändig|N OE D V EH N D IH G
nödvändighet|N OE D V EH N D IH G HH EH0 T
nörd|N OE RRR D
nördig|N OE RRR D IH G
nöt|N OE T
nötkråka|N OE T K RRR OW0 K AE
nött|N ER T
o|UH
obelisk|OW0 B EH L IH S K
objekt|AO B Y EH K T
objektiv|AO B Y EH K T IY V
obskyr|AO B S K Y UW1 RRR
och|AO K
ock|AO K
odjur|UW Y UW RRR
offert|UH F AE T
officiell|AO F IY S Y EH L
offside|AO F S AE Y D
ogge|AO G EH
ogilla|UW Y IH L AE
ohemul|UW HH EH0 M UW L
ohygglig|UH HH G L IH G
okapabel|UW K AE P AA B EH L
okej|UH K EH Y
oklar|UW K L AA RRR
oktober|UH K T UH B EH RRR
okynnesäta|UW SH N EH S EH T AE
olaglig|UW L AA G L IH G
olle|UH L EH
ollon|AO L AO N
olof|UW L AO V
olycka|UW L K AE
olycklig|UW L K L IH G
om|AO M
ombudsman|AO M B UW D S M AE N
omfång|AO M F AO NG
omljud|AO M Y UW D
omständig|AO M S T EH N D IH G
omständlig|AO M S T EH N D L IH G
omöjlig|UW M OE Y L IH G
onsdag|UH N S D AA G
orange|UH RRR AE NG EH
ord|UW RRR D
ordbok|UW RRR D B UW K
orden|AO RRR D EH N
ordentlig|UH D EH NG K L IH G
order|AO RRR D EH RRR
ordning|AO RRR D N IH NG
orientering|AO RRR Y EH N T EH0 RRR IH NG
orientseglare|AO R IH Y EH N T S EH0 G L AE R EH
orienttalgoxe|OW0 RRR IY Y EH N T AE L Y OW0 K S UH1
orientvadarsvala|AO RRR Y EH N T V AA D AE RRR S V AA L AE
orka|AO RRR K AE
orkan|UH RRR K AA N
orm|UH RRR M
orma|UH RRR M AE
ormörn|UH RRR M OE RRR N
ort|UH T
osa|UW S AE
oscar|AO S K AE RRR
oskar|AO S K AE RRR
oslo|UH S L UH
oss|AO S
osäker|UW S EH K EH RRR
otagbar|UW T AA G B AA RRR
otålig|UW T OW0 L IH G
ovan|UW V AA N
ove|UW V EH
overall|UH V EH RRR OW0 L
oxid|AO K S IY D
oändlig|UH EH N D L IH G
page|P AA
paj|P AE Y
paket|P AE K EH0 T
palats|P AE L AE T S
palladium|P AE L AA D IH UH M
palmduva|P AE L M D UW V AE
pals|P AE L S
paludarium|P AA L UH D AA RRR IH UH M
panda|P AE N D AE
panpsykism|P AE N P S Y UW1 K IH S M
panteon|P AE N T EH0 UH N
pantoffel|P AE N T AO F EH L
papegojalka|P AE P EH G AO Y AE L K AE
papper|P AE P EH RRR
paraply|P AE RRR AE P L Y UW1
parentes|P AE RRR EH N T EH0 S
paris|P AE RRR IY S
part|P AA T
partiell|P AE RRR SH EH L
passage|P AE S AA SH
passagerare|P AE S AE EH0 RRR AE RRR EH
pastej|P AE S T EH Y
patent|P AE T EH N T
paul|P OW0 L
paulina|P AE UH L IY N AE
paus|P AE UH S
pava|P AA V AE
pax|P AE K S
ped|P EH0 D
peda|P EH0 D
pedagog|P EH0 D AE G OW0 G
pekoral|P EH0 K UH RRR AA L
peng|P EH NG
pension|P AE N UW N
penultima|P EH0 N UH L T IH M AE
pep|P EH0 P
peppar|P EH P AE RRR
period|P EH RRR Y UW D
persilja|P EH RRR S IH L Y AE
person|P EH RRR S UW N
personlig|P EH SH OW0 N L IH G
personligen|P EH RRR S UW N L IH G EH N
peter|P EH T AH0 RRR
picka|P IH K AE
pigg|P IH G
pille|P IH L EH
pin|P IH N
pinje|P IH N Y EH
pipare|P IY P AE R EH
piparsnäppa|P IY P AE RRR S N EH P AE
piper|P IY P EH RRR
pirog|P IH RRR OW0 G
pizza|P IH T S AE
pjäs|P Y EH S
pladdra|P L AE D RRR AE
planta|P L AE N T AE
platina|P L AA T IH N AE
platt|P L AE T
plocka|P L AO K AE
plundring|P L UH N D RRR IH NG
pluskvamperfekt|P L UH S K V AE M P EH RRR F EH K T
plös|P L OE S
podd|P AO D
pojk|P AO Y K
pojkar|P AO Y K AE RRR
pojke|P AO Y K EH
pokal|P UH K AA L
pol|P UW L
polarvarg|P UH L AA RRR V AE RRR Y
politik|P UH L IH T IY K
politiker|P UH L IH T IY K EH RRR
polska|P AO L S K AE
ponke|P AO NG K EH
pool|P UW L
post|P AO S T
postavi|P AO S T AA V IY
potatiskorv|P UH T AA T IH S K AO RRR V
praktejder|P R AE K T EH Y D EH R
praktmes|P R AE K T M EH0 S
prao|P RRR AA UH
praoa|P RRR AE UH AE
prat|P RRR AA T
prata|P RRR AA T AE
precis|P RRR EH S IH S
presens|P RRR EH0 S EH N S
present|P RRR EH0 S EH0 N T
pressmeddelande|P RRR EH S M EH0 D EH0 L AE N D EH
pretentiös|P RRR EH T AE N OE S
pretentiöst|P RRR EH T AE N ER S T
preussen|P RRR AO Y S EH N
prilla|P RRR IH L AE
princip|P RRR IH N S IY P
pris|P RRR IY S
privatjet|P RRR IH V AA T Y EH T
problem|P RRR UH B L EH0 M
procent|P RRR UH S EH N T
process|P RRR UH S EH S
prognos|P RRR AO G N OW0 S
prosa|P RRR UW S AE
prosit|P RRR UW S IH T
proton|P RRR UH T OW0 N
prutgås|P R UW T G OW0 S
prutt|P RRR UH T
prutta|P RRR UH T AE
prärielöpare|P RRR EH RRR IH Y EH L OE P AE RRR EH0
prärietrana|P R EH R IH Y EH T R AA N AE
prärievarg|P RRR EH RRR IH EH V AE RRR Y
pröva|P RRR OE V AE
prövning|P RRR OE V N IH NG
puka|P UW K AE
pulka|P UH L K AE
pumla|P UH M L AE
pungmes|P UH NG M EH0 S
punkt|P UH NG K T
punktlig|P UH NG T L IH G
purpurhäger|P UH RRR P UH RRR HH EH G EH RRR
pusha|P UH AE
puss|P UH S
pussa|P UH S AE
pys|P Y UW1 S
pyttipanna|P T IH P AE N AE
pära|P AE RRR AE
päron|P AE RRR AO N
på|P OW0
påg|P OW0 G
pålägg|P OW0 L EH G
påskalamm|P AO S K AE L AE M
påskas|P AO S K AE S
påskkärring|P AO S K SH EH RRR IH NG
påskmust|P AO S K M UH S T
påtår|P OW0 T OW0 RRR
pöl|P OE L
rabatt|RRR AE B AE T
rabba|RRR AE B AE
rabbemos|RRR AE B EH M UW S
rabbis|RRR AE B IH S
radar|RRR AA D AE RRR
radon|RRR AE D OW0 N
ragge|RRR AE G EH
ragnarök|RRR AE NG N AE RRR OE K
rajd|RRR AE Y D
rallhäger|RRR AE L HH EH G EH RRR
ram|RRR AA M
rand|RRR AE N D
ras|RRR AA S
rationell|RRR AE T UH N EH L
rauk|RRR AE UH K
realisationsvinstbeskattning|RRR EH0 AE L IH S AE UW N S V IH N S T B EH S K AE T N IH NG
recept|RRR EH S EH P T
red|RRR EH0 D
reform|RRR EH0 F AO RRR M
regera|RRR EH Y EH0 RRR AE
regering|RRR EH Y EH0 RRR IH NG
regi|RRR EH IY
regim|RRR EH IY M
regissör|RRR EH IH S OE RRR
register|RRR EH Y IH S T EH RRR
registrera|RRR EH G IH S T RRR EH0 RRR AE
regn|RRR EH NG N
regna|RRR EH0 NG N AE
rejäl|RRR EH Y EH L
reklam|RRR EH K L AA M
reklamera|RRR EH K L AE M EH0 RRR AE
rekommendera|RRR EH K UH M EH N D EH0 RRR AE
relation|RRR EH L AE UW N
relativitet|RRR EH L AE T IH V IH T EH0 T
relativitetsteori|RRR EH L AE T IH V IH T EH0 T S T EH UH RRR IY
religion|RRR EH L IH Y UW N
religiös|RRR EH L IH OE S
renommé|RRR EH N AO M EH0
renommésnyltning|RRR EH N AO M EH0 S N L T N IH NG
rent|RRR EH0 N T
rep|RRR EH0 P
replokal|RRR EH0 P L UH K AA L
reson|RRR EH S UW N
restaurang|RRR EH S T UH RRR AE NG
resultat|RRR EH S UH L T AA T
rev|RRR EH0 V
revolution|RRR EH V UH L UH UW N
reykjavik|RRR EH Y K Y AE V IY K
ribbstol|RRR IH B S T UW L
rik|RRR IY K
rike|RRR IY K EH
riksrätt|RRR IH K S RRR EH T
rikssvenska|RRR IH K S S V EH N S K AE
riktig|RRR IH K T IH G
ringand|R IH NG AE N D
ringduva|R IH NG D UW V AE
ris|RRR IY S
robert|RRR OW0 B EH T
rock|RRR AO K
roffe|RRR AO F EH
rom|RRR UH M
romare|RRR UH M AE RRR EH
ros|RRR UW S
rosa|RRR UW S AE
rosenstare|RRR UW S EH N S T AA RRR EH
rosentärna|RRR UW S EH N T UH1 RRR N AE
rosett|RRR UH S EH T
roskarl|RRR UW S K AA RRR L
rostand|R AO S T AE N D
rostgumpsvala|RRR AO S T G UH M P S V AA L AE
rostmes|RRR AO S T M EH0 S
rot|RRR UW T
rotmos|RRR UW T M UW S
rotting|RRR AO T IH NG
rov|RRR UW V
rova|RRR UW V AE
ruckel|RRR UH K EH L
rulle|RRR UH L EH
rum|RRR UH M
rumänska|RRR UH M EH N S K AE
russin|RRR UH S IH N
rwanda|RRR V AE N D AE
ryska|RRR S K AE
ryssja|RRR AE
ryttare|RRR T AE RRR EH0
räd|RRR EH D
rälig|RRR EH L IH G
ränna|RRR EH N AE
räv|RRR EH V
rävar|RRR EH V AE RRR
rävtik|RRR EH V T IY K
rävtikar|RRR EH V T IY K AE RRR
rävtiken|RRR EH V T IY K EH N
rävunge|RRR EH V UH NG EH
rå|RRR OW0
råd|RRR OW0 D
rådjur|RRR OW0 Y UW RRR
råg|RRR OW0 G
rån|RRR OW0 N
råtta|RRR AO T AE
röd|RRR OE D
rödbena|RRR OE D B EH0 N AE
rödfalk|RRR OE D F AE L K
rödlök|RRR OE D L OE K
rödspov|RRR OE D S P UW V
rödvarg|RRR OE D V AE RRR Y
rök|RRR OE K
rökfritt|RRR OE K F RRR IH T
rökning|RRR OE K N IH NG
rölleka|RRR ER L EH K AE
rörhöna|R OE R HH OE N AE
rörlig|RRR ER L IH G
rörsångare|RRR OE RRR S AO NG AE RRR EH
rösa|RRR OE S AE
röst|RRR ER S T
rövslickare|RRR OE V S L IH K AE RRR EH
sa|S AA
sabla|S AA B L AE
sabotage|S AE B UH T AA
sade|S AA D EH
saft|S AE F T
sagt|S AE K T
sak|S AA K
sakna|S AA K N AE
saldo|S AE L D UH
salt|S AE L T
sam|S AE M
sambo|S AE M B UW
samling|S AE M L IH NG
sammanhänga|S AE M AE N HH EH NG AE
samt|S AE M T
samtal|S AE M T AA L
sandig|S AE N D IH G
sandlöpare|S AE N D L OE P AE RRR EH0
sandsnäppa|S AE N D S N EH P AE
sandtärna|S AE N D T UH1 RRR N AE
sandvita|S AE N D V IY T AE
sareptasenap|S AE RRR EH P T AE S EH0 N AE P
satan|S AA T AE N
saturnus|S AE T UH RRR N UH S
schack|AE K
schampo|AE M P UH
schasa|AA S AE
schejk|EH Y K
schema|EH0 M AE
schlager|L AA G EH0 RRR
schweiz|SH V EH Y T S
se|S EH0
sedan|S EH N
sedel|S EH0 D EH L
seeda|S IY D AE
seg|S EH0 G
seger|S EH0 G EH RRR
segling|S EH0 G L IH NG
sejour|S EH UW RRR
selen|S EH L EH0 N
semester|S EH M EH S T EH RRR
semestrar|S EH M EH S T RRR AE RRR
semla|S EH M L AE
sen|S EH N
senapsgul|S EH0 N AE P S G UW L
senapssill|S EH0 N AE P S S IH L
sent|S EH0 N T
separation|S EH0 P AE RRR AE UW N
september|S EH P T EH M B EH RRR
serve|S UH RRR V
set|S EH T
seta|S EH T AE
sett|S EH T
sevilla|S EH V IY AE
sex|S EH K S
sextio|S EH K S T IH UH
sexton|S EH K S T AO N
sexualitet|S EH K S UH AE L IH T EH0 T
sexualkunskap|S EH K S UH AA L K UH N S K AA P
shetlandsöarna|EH T L AE N D S OE AE N AE
shobresvenska|SH UW B RRR EH S V EH N S K AE
shopping|AO P IH NG
shorts|SH OW0 T SH
show|AO
sida|S IY D AE
sig|S EH Y
sikt|S IH K T
silkeshäger|S IH L K EH S HH EH G EH RRR
sill|S IH L
sillgrissla|S IH L G RRR IH S L AE
silltrut|S IH L T RRR UW T
silver|S IH L V EH RRR
silvertärna|S IH L V EH RRR T UH1 RRR N AE
simma|S IH M AE
sin|S IY N
sinfonietta|S IH N F AO N IH EH T AE
sinnes|S IH N EH S
sitar|S IH T AA RRR
sitt|S IH T
sitta|S IH T AE
situation|S IH T UH AE UW N
sjal|AA L
sjok|UW K
sju|UW
sjucker|UH K EH RRR
sjuda|UW D AE
sjuk|UW K
sjuka|UW K AE
sjukdom|UW K D UH M
sjukhus|UW K HH UW S
sjukna|UW K N AE
sjuksköterska|UW K OE T EH RRR S K AE
sjukt|UW K T
sjunde|UH N D EH
sjunga|UH NG AE
sjunka|UH NG K AE
sjuttio|UH T IH UH
sjutton|UH T AO N
själ|EH L
själv|EH L V
självklar|EH L V K L AA RRR
självklarhet|EH L V K L AA RRR HH EH0 T
sjätte|EH T EH
sjö|OE
sjökalv|OE K AE L V
sjökvist|OE K V IH S T
sjöman|OE M AE N
sjön|ER N
sjöorre|OE AO R EH
sjöquist|OE K V IH S T
sjöqvist|OE K V IH S T
ska|S K AA
skabb|S K AE B
skaffel|AE F EH L
skakis|S K AA K IH S
skakning|S K AA K N IH NG
skall|S K AE L
skam|S K AE M
skandium|S K AE N D IH UH M
skapa|S K AA P AE
skapelse|S K AA P EH L S EH
skatgök|S K AA T Y OE K
ske|EH0
sked|EH0 D
skedand|EH0 D AE N D
skedstork|EH0 D S T AO RRR K
sken|EH0 N
skepp|EH P
skepparkrans|EH P AE RRR K RRR AE N S
skeptisk|EH P T IH S K
sket|EH0 T
skev|EH0 V
skicka|IH K AE
skiffer|IH F EH RRR
skiffermes|IH F EH R M EH0 S
skiffertrut|IH F EH RRR T RRR UW T
skildring|IH L D RRR IH NG
skilja|IH L Y AE
skilling|IH L IH NG
skillnad|IH L N AE D
skina|IY N AE
skinn|IH N
skit|IY T
skiva|IY V AE
skjorta|UH RRR T AE
skjul|UW L
skjuta|UW T AE
skjutglad|UW T G L AA D
skjutsa|UH S AE
sko|S K UW
skock|S K AO K
skogsduva|S K UH G D UW V AE
skogssnäppa|S K UH G S S N EH P AE
skogsstjärna|S K UH K S EH RRR N AE
skola|S K UW L AE
skolbespisning|S K UW L B EH S P IY S N IH NG
skolka|S K AO L K AE
skolmat|S K UW L M AA T
skolmatsal|S K UW L M AA T S AA L
skorsten|S K AO SH T EH0 N
skorstensseglare|S K AO SH T EH0 N S EH0 G L AE R EH
skoskav|S K UW S K AA V
skotskt|S K AO T S K T
skottland|S K AO T L AE N D
skraj|S K RRR AE Y
skribent|S K RRR IH B EH N T
skridsko|S K RRR IH S K UH
skrik|S K RRR IY K
skrikstrandpipare|S K RRR IY K S T RRR AE N D P IY P AE RRR EH
skrikörn|S K RRR IY K OE RRR N
skrin|S K RRR IY N
skriva|S K RRR IY V AE
skrivmaskin|S K RRR IY V M AE IY N
skrivning|S K RRR IY V N IH NG
skrota|S K RRR UW T AE
skruv|S K RRR UW V
skrämma|S K RRR EH M AE
skräntärna|S K RRR EH N T UH1 RRR N AE
skula|S K UW L AE
skull|S K UH L
skulle|S K UH L AH0
skumvin|S K UW M V IY N
skur|S K UW RRR
skvader|S K V AA D EH RRR
sky|Y UW1
skydd|D
skyddshjälm|D S Y EH L M
skyddsväg|SH Y UW1 D S V EH0 G
skyfall|F AE L
skygg|G
skyhög|HH OE G
skylt|L T
skymma|M AE
skymning|M N IH NG
skytt|T
skytte|T EH
skytten|T EH N
skägg|EH G
skäggdopping|EH G D AO P IH NG
skäggmes|EH G M EH0 S
skäggtärna|EH G T UH1 RRR N AE
skäl|EH L
skälig|EH L IH G
skämskudde|EH M S K UH D EH
skämt|EH M T
skänka|EH NG K AE
skär|AE RRR
skära|AE RRR AE
skärfläcka|EH R F L EH K AE
skärp|SH AE RRR P
skärpa|AE RRR P AE
skärsnäppa|EH RRR S N EH P AE
skåda|S K OW0 D AE
sköld|ER L D
sköldpadda|ER L D P AE D AE
skölja|ER L Y AE
skön|OE N
skönhetssalong|OE N HH EH0 T S S AE L AO NG
skörbjugg|ER RRR B Y UH G
sköt|OE T
sköts|OE T S
slagsmål|S L AE K S M OW0 L
slaguggla|S L AA G UH G L AE
slangens|S L AE NG EH0 N S
sleva|S L EH0 V AE
slitvarg|S L IY T V AE RRR Y
slog|S L UW G
slogs|S L UH K S
slussa|S L UH S AE
slut|S L UW T
sluten|S L UW T EH N
slutrea|S L UW T RRR EH0 AE
slutspurt|S L UW T S P UH RRR T
släkt|S L EH K T
slät|S L EH T
slå|S L OW0
slån|S L OW0 N
slö|S L OE
slöjd|S L ER Y D
slösa|S L OE S AE
slöseri|S L OE S EH RRR IY
smarrig|S M AE RRR IH G
smaska|S M AE S K AE
smaskig|S M AE S K IH G
smed|S M EH0 D
smet|S M EH0 T
smittkurva|S M IH T K UH RRR V AE
smoking|S M OW0 K IH NG
smulgubbe|S M UW L G UH B EH
smultron|S M UH L T RRR AO N
smultronställe|S M UH L T RRR AO N S T EH L EH
smurf|S M UH RRR F
smutsgam|S M UH T S G AA M
smyg|S M Y UW1 G
små|S M OW0
småborgare|S M OW0 B AO RRR Y AE RRR EH0
småborgerlig|S M OW0 B AO RRR Y EH RRR L IH G
småborgerlighet|S M OW0 B AO RRR Y EH RRR L IH G HH EH0 T
smådopping|S M OW0 D AO P IH NG
småkusin|S M OW0 K UH S IY N
smålom|S M OW0 L UH M
småskrake|S M OW0 K R AA K EH
småskuren|S M OW0 S K UW RRR EH N
småsnäppa|S M OW0 S N EH P AE
småtrapp|S M AO T R AE P
småtärna|S M OW0 T UH1 RRR N AE
smör|S M OE RRR
smörgås|S M ER RRR G AO S
smörgåsbord|S M ER RRR G AO S B UW RRR D
smörgåstårta|S M ER RRR G AO S T OW0 RRR T AE
snabb|S N AE B
snabbt|S N AE P T
snacka|S N AE K AE
snapsvisa|S N AE P S V IY S AE
snart|S N AA T
snatterand|S N AE T EH R AE N D
sne|S N EH0
snickare|S N IH K AE RRR EH
snickeri|S N IH K EH RRR IY
snickra|S N IH K RRR AE
snida|S N IY D AE
sno|S N UW
snor|S N UW RRR
snowboots|S N AO UW B AO T S
snudd|S N UH D
snus|S N UW S
snusa|S N UW S AE
snusare|S N UW S AE RRR EH
snusig|S N UW S IH G
snuskhummer|S N UH S K HH UH M EH RRR
snusmumrik|S N UW S M UH M RRR IH K
snut|S N UW T
snutt|S N UH T
snygging|S N G IH NG
snylta|S N L T AE
snyltning|S N L T N IH NG
snäll|S N EH L
snälla|S N EH L AE
snäppa|S N EH P AE
snål|S N OW0 L
snåljåp|S N OW0 L Y OW0 P
snålvarg|S N OW0 L V AE RRR Y
snö|S N OE
snöa|S N OE AE
snöga|S N OE G AE
snön|S N ER N
so|S UW
social|S OW0 AA L
sockenmål|S UH K EH N M OW0 L
soda|S UW D AE
sofia|S UH F IY AE
sol|S UW L
solk|S AO L K
solna|S OW0 L N AE
solsken|S UW L EH0 N
solvarg|S UW L V AE RRR Y
som|S AO M
somaliames|S AO M AA L Y AE M EH0 S
sommar|S AO M AE RRR
sommartid|S AO M AE RRR T IY D
somras|S AO M RRR AE S
son|S OW0 N
soppa|S AO P AE
sorg|S AO RRR Y
sorl|S OW0 RRR L
sortering|S UH RRR T EH0 RRR IH NG
sosse|S UH S EH
sossig|S UH S IH G
sot|S UW T
sothöna|S UW T HH OE N AE
sotis|S UW T IH S
sottärna|S UW T T UH1 RRR N AE
sov|S OW0 V
sova|S OW0 V AE
sovel|S OW0 V EH L
sovjet|S UH V Y EH T
sovstad|S OW0 V S T AA D
spanska|S P AE N S K AE
spara|S P AA RRR AE
sparvuggla|S P AE RRR V UH G L AE
spasm|S P AE S M
spegel|S P EH0 G EH L
spel|S P EH0 L
spela|S P EH0 L AE
spelar|S P EH0 L AE RRR
spenat|S P EH N AA T
speta|S P EH0 T AE
spetsbergsgrissla|S P EH T S B EH RRR Y S G RRR IH S L AE
spetsbergsgås|S P EH T S B EH R Y S G OW0 S
spettekaka|S P EH T EH K AA K AE
spetälska|S P EH0 T AE L S K AE
spik|S P IY K
spis|S P IY S
spisa|S P IY S AE
spjut|S P Y UW T
sport|S P UH T
spov|S P UW V
spovsnäppa|S P UH V S N EH P AE
sprida|S P RRR IY D AE
sprit|S P RRR IY T
spruta|S P RRR UW T AE
språk|S P RRR OW0 K
spurt|S P UH RRR T
spy|S P Y UW1
spänna|S P EH N AE
spå|S P OW0
spåga|S P OW0 G AE
spår|S P OW0 RRR
spö|S P OE
spöke|S P OE K EH
spöregn|S P OE RRR EH NG N
stab|S T AA B
stad|S T AA D
stadig|S T AA D IH G
stadsbo|S T AE T S B UW
stal|S T AA L
stamområde|S T AE M AO M RRR OW0 D EH
stat|S T AA T
station|S T AE UW N
stationär|S T AE T UH N AE RRR
statlig|S T AA T L IH G
stav|S T AA V
stava|S T AA V AE
stege|S T EH0 G EH
stel|S T EH0 L
sten|S T EH0 N
stenfalk|S T EH0 N F AE L K
stensvala|S T EH0 N S V AA L AE
stickelbär|S T IH K EH L B EH RRR
stig|S T IY G
stillhet|S T IH L HH EH0 T
stjäl|EH L
stjäla|EH L AE
stjälk|EH L K
stjälpa|EH L P AE
stjärt|EH RRR T
stjärtand|EH T AE N D
stockholm|S T AO K HH AO L M
stockholmssyndrom|S T AO K HH AO L M S S N D RRR OW0 M
stod|S T UW G
stoft|S T AO F T
stol|S T UW L
stomme|S T UW M EH0
stor|S T UW RRR
storlabb|S T UW RRR L AE B
storlom|S T UW RRR L UH M
storm|S T AO RRR M
stormaktstid|S T UW RRR M AE K T S T IY D
stormfågel|S T AO RRR M F OW0 G EH L
storskrake|S T UW R S K R AA K EH
storspov|S T UW RRR S P UW V
stortrapp|S T UW R T R AE P
stova|S T OW0 V AE
strandskata|S T R AE N D S K AA T AE
strass|S T RRR AE S
strejk|S T RRR EH Y K
strontium|S T RRR AO N T S IH UH M
stryka|S T RRR Y UW1 K AE
stråla|S T R OW0 L AE
stråle|S T RRR OW0 L AH0
ströbröd|S T RRR ER B RRR ER D
ström|S T RRR ER M
strömand|S T R ER M AE N D
strömming|S T RRR ER M IH NG
stubb|S T UH B
stubbstjärtseglare|S T UH B EH T S EH0 G L AE R EH
student|S T UH D EH N T
studio|S T UW D IH UH
studsa|S T UH T S AE
stuga|S T UW G AE
stulit|S T UW L IH T
stut|S T UW T
stuva|S T UW V AE
styltlöpare|S T L T L OE P AE R EH
styltsnäppa|S T L T S N EH P AE
städerska|S T EH D EH SH K AE
ställningstagande|S T EH L N IH NG S T AA G AE N D EH
stämma|S T EH M AE
stäpp|S T EH P
stäppflyghöna|S T EH P F L Y UW1 G HH OE N AE
stäpphök|S T EH P HH OE K
stäppsångare|S T EH P S AO NG AE RRR EH
stäppvarg|S T EH P V AE RRR Y
stäppvipa|S T EH P V IY P AE
stäppörn|S T EH P OE RRR N
stå|S T OW0
stål|S T OW0 L
stöd|S T OE D
störa|S T ER RRR AE
störtregn|S T T RRR EH NG N
störtskur|S T T S K UW RRR
subjekt|S UH B Y EH K T
subjektiv|S UH B Y EH K T IY V
substantiv|S UH B S T AE N T IY V
succé|S UW K S EH0
suck|S UH K
sumpvipa|S UH M P V IY P AE
sund|S UH N D
sundsvall|S UH N D S V AE L
supa|S UW P AE
super|S UW P EH RRR
supinum|S UH P IY N UH M
sur|S UW RRR
sura|S UW RRR AE
surpuppa|S UW RRR P UH P AE
surströmming|S UW RRR S T RRR ER M IH NG
svag|S V AA G
svala|S V AA L AE
svan|S V AA N
svans|S V AA N S
svansrem|S V AE N S RRR EH M
svar|S V AA RRR
svara|S V AA RRR AE
svart|S V AE RRR T
svartand|S V AE T AE N D
svarthakedopping|S V AE T HH AA K EH D AO P IH NG
svartis|S V AE RRR T IH S
svartkråka|S V AE RRR T K RRR OW0 K AE
svartpeppar|S V AE T P EH P AE R
svartsenap|S V AE T S EH0 N AE P
svartsnäppa|S V AE RRR T S N EH P AE
svarttärna|S V AE RRR T T UH1 RRR N AE
svarv|S V AE RRR V
svavel|S V AA V EH L
sveg|S V EH0 G
svek|S V EH0 K
sven|S V EH N
svensk|S V EH N S K
svenska|S V EH N S K AE
svenskjävel|S V EH N S K Y EH V EH L
sverige|S V EH RRR Y EH
svika|S V IY K AE
svit|S V IY T
svor|S V UW RRR
svärd|S V AE RRR D
svärta|S V EH T AE
svåger|S V OW0 G AH0 RRR
svår|S V OW0 RRR
svårt|S V OW0 T
swisha|S W IH SH AE
syd|S Y UW1 D
sydafrikansk|S D AE F RRR IY K AE N S K
sydkorea|S Y UW1 D K UH RRR EH0 AE
sydsamiska|S Y UW1 D S AA M IH S K AE
syl|S Y UW1 L
syll|S L
sylt|S L T
sylta|S L T AE
sylvass|S Y UW1 L V AE S
symfoni|S M F UH N IY
symfoniorkester|S M F UH N IY AO RRR K EH S T EH RRR
syntes|S N T EH0 S
syra|S Y UW1 RRR AE
syrak|S Y UW1 RRR AE K
syre|S Y UW1 RRR EH
syrra|S RRR AE
syssling|S S L IH NG
syssna|S S N AE
systemet|S S T EH0 M EH T
syster|S S T EH RRR
sädesfrö|S EH D EH S F RRR OE
sädgås|S EH D G OW0 S
säga|S EH Y AE
säl|S EH L
sälarna|S AE L AE N AE
sälg|S EH L Y
sälja|S EH L Y AE
säljare|S EH L Y AE RRR EH0
säll|S EH L
säng|S EH NG
sängram|S EH NG RRR AA M
säpo|S EH P UH
särbo|S EH RRR B UW
särskild|S EH RRR IH L D
särskrivning|S EH RRR S K RRR IY V N IH NG
sätt|S EH T
sävsångare|S EH V S AO NG AE RRR EH
så|S OW0
såg|S OW0 G
sågverk|S OW0 G V EH RRR K
sån|S AO N
sång|S AO NG
sångsvan|S AO NG S V AA N
sånär|S AO N EH RRR
sår|S OW0 RRR
sås|S OW0 S
söder|S OE D AH0 RRR
södermanland|S ER RRR M L AE N D
södertälje|S ER D EH T EH L Y EH
sökbar|S OE K B AA RRR
söm|S ER M
sömn|S ER M N
söndag|S ER N D AA G
söt|S OE T
sötebröd|S OE T EH B RRR OE D
sötebrödsdagar|S OE T EH B RRR OE D S D AA G AE RRR
sött|S ER T
söul|S OE UW L
t|T EH0
ta|T AA
tabbe|T AE B EH
tack|T AE K
tag|T AA G
taggstjärtseglare|T AE G EH T S EH0 G L AE R EH
taiwanmes|T AE Y W AE N M EH0 S
tajgasädgås|T AE Y G AE G OW0 S
tajgasångare|T AE Y G AE S AO NG AE RRR EH
tak|T AA K
tala|T AA L AE
talang|T AE L AE NG
talko|T AE L K AO
tall|T AE L
tallbit|T AE L B IY T
tallgråmes|T AE L G R OW0 M EH0 S
talong|T AE L AO NG
tambur|T AE M B UW RRR
tand|T AE N D
tango|T AE NG G UH
tanig|T AA N IH G
tanke|T AE NG K EH
tankesmedja|T AE NG K EH S M EH0 D Y AE
tant|T AE N T
tarzan|T AE SH AE N
tasse|T AE S EH
tassemark|T AE S EH M AE RRR K
tatarfalk|T AE T AA RRR F AE L K
tatta|T AE T AE
tattare|T AE T AE RRR EH0
tatuera|T AE T UH EH0 RRR AE
te|T EH0
team|T IY M
teg|T EH0 G
telefon|T EH L EH F UW N
television|T EH L EH V IH UW N
teoretiker|T EH UH RRR EH0 T IH K EH RRR
teoretisk|T EH UH RRR EH0 T IH S K
teori|T EH UH RRR IY
tepumla|T EH0 P UH M L AE
terapeut|T AE RRR AE P EH V T
terapeutisk|T EH0 RRR AE P EH0 F T IH S K
terbium|T EH RRR B IH UH M
tereksnäppa|T EH RRR EH K S N EH P AE
teve|T EH0 V EH
therese|T EH RRR EH0 S
thunberg|T UW N B AE RRR Y
tid|T IY D
tiden|T IY N
tidning|T IY N IH NG
tiger|T IY G EH RRR
tik|T IY K
tikar|T IY K AE RRR
tiken|T IY K EH N
till|T IH L
tillbaka|T IH L B AA K AE
tillförordnad|T IH L F ER RRR OW0 RRR D N AE D
tillhandahålla|T IH L HH AE N D AE HH AO L AE
tills|T IH S
tillsammans|T IH L S AE M AE N S
tillverkare|T IH L V EH RRR K AE RRR EH
timmar|T IH M AE RRR
tina|T IY N AE
tio|T IY UH
tionde|T IY AO N D EH
tisdag|T IY S D AA G
titan|T IH T AA N
titel|T IH T EH L
tivoli|T IH V UH L IY
tja|SH AE
tjabba|SH AE B AE
tjalla|SH AE L AE
tjeck|SH EH K
tjej|SH EH Y
tjena|SH EH0 N AE
tjenare|SH EH0 N AE RRR EH
tjenixen|SH EH0 N IH K S EH N
tji|SH IY
tjock|SH AO K
tjockfot|AO K F UW T
tjog|SH OW0 G
tjorre|SH AO RRR EH
tjuga|SH UW G AE
tjugo|SH UH
tjugonde|SH UW G AO N D EH
tjugotredje|SH UW G UH T RRR EH0 D Y EH0
tjur|SH UW RRR
tjuring|SH UW RRR IH NG
tjusa|SH UW S AE
tjuta|SH UW T AE
tjuv|SH UW V
tjuvsena|SH UW V S EH0 N AE
tjänare|EH N SH EH0 N AE RRR EH
tjänixen|SH EH N IH K S EH N
tjära|SH EH RRR AE
tjärn|SH EH RRR N
tjôta|SH ER T AE
tjöta|SH ER T AE
toa|T UW AE
toalett|T UW AE L EH T
tobak|T UW B AE K
tobisgrissla|T UW B IH S G RRR IH S L AE
toffelhjälte|T AO F EH L Y EH L T EH
tofflor|T AO F L UH R
tofslunne|T AO F S L UH N EH
tofsvipa|T AO F S V IY P AE
tog|T UW G
tok|T UW K
tolfte|T AO L F T EH
tolv|T AO L V
tom|T UW M
tomte|T AO M T EH0
tomten|T AO M T EH N
ton|T AO N
tonartshöjning|T UW N AE RRR T S HH ER Y N IH NG
toppskarv|T AO P S K AE RRR V
tor|T UW RRR
torg|T AO RRR Y
torium|T UW RRR IH UH M
tornedalen|T OW0 RRR N EH D AA L EH N
tornedalsfinska|T OW0 RRR N EH D AA L S F IH N S K AE
tornseglare|T UW NG S EH0 G L AE R EH
torsdag|T UW RRR S D AA G
toscakaka|T AO S K AE K AA K AE
total|T UH T AA L
tragedi|T RRR AE EH D IY
trapp|T R AE P
trast|T RRR AE S T
trastsångare|T RRR AE S T S AO NG AE RRR EH
tre|T RRR EH0
tredje|T RRR EH0 D Y EH
tremänning|T RRR EH0 M EH N IH NG
tretal|T RRR EH0 T AA L
trettio|T RRR EH T IH UH
tretton|T RRR EH T AO N
triljard|T RRR IH L Y AA RRR D
triljon|T RRR IH L Y UW N
trivas|T RRR IY V AE S
trivsel|T RRR IH V S EH0 L
tro|T RRR UW
troca|T RRR AO K AE
troll|T RRR AO L
trolla|T RRR AO L AE
tromsø|T RRR UH M S ER
tron|T RRR UW N
trona|T RRR N AE
tror|T RRR UW RRR
trosa|T RRR UW S AE
truga|T RRR UW G AE
trumpet|T RRR UH M P EH0 T
trä|T RRR EH
träd|T RRR EH D
trädgård|T RRR EH G AO RRR D
trädmås|T RRR EH D M OW0 S
trädpiplärka|T RRR EH D P IY P L EH RRR K AE
träl|T RRR EH L
träldom|T RRR EH L D UH M
träna|T RRR EH N AE
tränga|T RRR EH NG AE
tråd|T RRR OW0 D
tråg|T RRR OW0 G
tröska|SH EH RRR T UH1 RRR N AE
tsar|T S AA RRR
tsunami|T S UW N AA M IH
tuff|T UH F
tukan|T UH K AA N
tundrasnäppa|T UH N D RRR AE S N EH P AE
tundravarg|T UH N D RRR AE V AE RRR Y
tung|T UH NG
tunga|T UH NG AE
tungel|T UH NG EH L
tunnbröd|T UH N B RRR ER D
tunnbrödsrulle|T UH N B RRR ER D S RRR UH L EH
tunnel|T UH N EH L
tunnelbana|T UH N EH L B AA N AE
turban|T UH RRR B AA N
turkestantörnskata|T UH RRR K EH S T AA N T OE RRR N S K AA T AE
tusen|T UW S EH N
tuvsnäppa|T UW V S N EH P AE
tv|T EH0 V EH
tvedräkt|T V EH0 D RRR EH K T
tveeggad|T V EH0 EH G AE D
tvegifte|T V EH0 Y IH F T EH
tvehågsen|T V EH0 HH OW0 G S EH N
tvehövdad|T V EH0 HH ER V D AE D
tvesovla|T V EH0 S OW0 V L AE
tvestjärt|T V EH0 EH RRR T
tvivla|T V IY V L AE
tvärtom|T V EH T AO M
tvättbjörn|T V EH T B Y OE N
tvätterska|T V EH T EH SH K AE
tvättmedel|T V EH T M EH0 D EH L
två|T V OW0
tvång|T V AO NG
tvångssvenska|T V AO NG S S V EH N S K AE
ty|T Y UW1
tycka|T K AE
tyda|T Y UW1 D AE
tyg|T Y UW1 G
tygelmes|T Y UW1 G EH L M EH0 S
tygeltärna|T Y UW1 G EH L T UH1 RRR N AE
tykobrahedag|T K UH B RRR AA EH D AA G
tyngst|T NG S T
tysk|T S K
tyska|T S K AE
tyskland|T S K L AE N D
tyst|T S T
tzatziki|T S AE T S IY K IH
täcke|T EH K EH
täckt|T EH K T
täkt|T EH K T
tända|T EH N D AE
tänkte|T EH NG K T EH
tärnmås|T EH RRR N M OW0 S
tå|T OW0
tåg|T OW0 G
tår|T OW0 RRR
tö|T OE
töras|T OE RRR AE S
törnekrona|T OE RRR N EH K RRR UW N AE
törnskata|T OE RRR N S K AA T AE
u|UW
uefa|UH EH0 F AE
uer|UW EH RRR
ugn|UH NG N
ukulele|UH K UH L EH0 L EH
ull|UH L
ulla|UH L AE
ulrika|UH L RRR IY K AE
ulv|UH L V
umeå|UW M EH AO
under|UH N D EH RRR
ung|UH NG
ungefär|UH NG EH F AE RRR
universitet|UH N IH V EH SH IH T EH0 T
upp|UH P
uppehålla|UH P EH HH AO L AE
upprätt|UH P RRR EH T
upprätthålla|UH P RRR EH T HH AO L AE
uppsala|UH P S AA L AE
uppsaliensisk|UH P S AE L IH EH N S IH S K
uppstyrdhet|UH P S T Y UW1 RRR D HH EH0 T
uppträda|UH P T RRR EH D AE
uppträdande|UH P T RRR EH D AE N D EH0
uppvisning|UH P V IY S N IH NG
uppå|UH P OW0
ur|UW RRR
uran|UH RRR AA N
uranus|UH RRR AA N UH S
urgammal|UH RRR G AE M AE L
ursäkta|UW SH EH K T AE
usa|UW EH S AA
usch|UH
usel|UW S EH L
ut|UW T
utan|UW T AE N
utanför|UW T AE N F ER RRR
utbrott|UW T B RRR AO T
utge|UW T Y EH0
utgång|UW T G AO NG
utom|UW T AO M
utropa|UW T RRR UW P AE
utslag|UW T S L AA G
uttryck|UW T T RRR K
uv|UW V
uzbek|UH S B EH0 K
va|V AA
vabba|V AE B AE
vaccin|V AE K S IY N
vacker|V AE K EH RRR
vad|V AA D
vadstena|V AE S T EH0 N AE
vagnmakare|V AE NG N M AA K AE RRR EH
vaj|V AE Y
vaja|V AE Y AE
vajsing|V AE Y S IH NG
vakna|V AA K N AE
vakta|V AE K T AE
val|V AA L
valack|V AE L AE K
valacka|V AE L AE K AE
valfläsk|V AA L F L EH S K
valk|V AE L K
valka|V AE L K AE
valkning|V AE L K N IH NG
valsverk|V AE L S V EH RRR K
vampyr|V AE M P Y UW1 RRR
van|V AA N
vandrare|V AE N D RRR AE RRR EH
vandringsord|V AE N D RRR IH NG S UW RRR D
vann|V AE N
vapen|V AA P EH N
var|V AA R
vara|V AA RRR AE
varandra|V AE RRR AE N D RRR AE
varann|V AE RRR AE N
varest|V AA RRR EH S T
varfågel|V AA RRR F OW0 G EH L
varför|V AA RRR F ER RRR
varg|V AE RRR Y
vargatid|V AE RRR Y AE T IY D
vargavinter|V AE RRR Y AE V IH N T EH RRR
vargaväder|V AE RRR Y AE V EH D EH RRR
vargbiten|V AE RRR Y B IY T EH N
vargflock|V AE RRR Y F L AO K
varggrin|V AE RRR Y G RRR IY N
varggrop|V AE RRR Y G RRR UW P
varghagel|V AE RRR Y HH AA G EH L
varghund|V AE RRR Y HH UH N D
varginna|V AE RRR Y IH N AE
vargjakt|V AE RRR Y Y AE K T
vargpar|V AE RRR Y P AA RRR
vargpäls|V AE RRR Y P EH L S
vargrevir|V AE RRR Y RRR EH V IY RRR
vargskinn|V AE RRR Y IH N
vargspår|V AE RRR Y S P OW0 RRR
vargstam|V AE RRR Y S T AE M
vargtimma|V AE RRR Y T IH M AE
vargtimme|V AE RRR Y T IH M EH0
vargtjut|V AE RRR Y SH UW T
vargton|V AE RRR Y T UW N
vargunge|V AE RRR Y UH NG EH
vargvalp|V AE RRR Y V AE L P
varit|V AA T
varken|V AE RRR K EH N
varm|V AE RRR M
varmt|V AE RRR M T
vars|V AA RRR S
varse|V AA SH EH
varsågod|V AA RRR S AO G UW D
vart|V AA RRR T
varv|V AE RRR V
vas|V AA S
vasa|V AE S AA
vass|V AE S
vatten|V T EH N
vattenrall|V AE T EH N R AE L
vattensångare|V AE T EH N S AO NG AE RRR EH
vattentorn|V AE T EH N T UH N
vattnen|V AE T N EH N
vattnet|V AE T N EH T
ve|V EH0
vecka|V EH K AE
vek|V EH0 K
velociped|V EH L UH S IH P EH0 D
venus|V EH0 N UH S
verk|V AE RRR K
verka|V EH RRR K AE
verklighetsflykt|V EH RRR K L IH G HH EH0 T S F L K T
verkstad|V EH0 RRR K S T AE
vessla|V EH S L AE
veta|V EH0 T AE
vete|V EH0 T EH
veteran|V EH T EH RRR AA N
vetja|V EH T Y AE
vi|V IY
vid|V IY D
vidareutbilda|V IY D AE RRR EH UW T B IH L D AE
vidareutbildning|V IY D AE RRR EH UW T B IH L D N IH NG
videsångare|V IY D EH S AO NG AE RRR EH
vidskepelse|V IY D EH0 P EH L S EH
vidskeplig|V IY D EH0 P L IH G
vigsel|V IH K S EH0 L
vikt|V IY K T
vilja|V IH L Y AE
vill|V IH L
ville|V IH L EH
vin|V IY N
vind|V IH N D
vindtunnel|V IH N D T UH N EH L
viner|V IY N EH RRR
vinge|V IH NG EH
vinter|V IH N T EH RRR
vintertid|V IH N T EH RRR T IY D
vintras|V IH N T RRR AE S
viol|V IH UW L
viola|V IH UW L AE
violinist|V IH UH L IH N IH S T
vipa|V IY P AE
virre|V IH RRR EH
vischan|V IH AE N
vision|V IH UW N
vismut|V IH S M UH T
vit|V IY T
vitgumpseglare|V IY T G UH M P S EH0 G L AE R EH
vitgumpsnäppa|V IY T G UH M P S N EH P AE
vitrysk|V IY T RRR S K
vitryska|V IY T RRR S K AE
vitsenap|V IY T S EH0 N AE P
vittrut|V IY T T RRR UW T
viv|V IY V
vodka|V AO D K AE
volfram|V AO L F RRR AE M
volvo|V AO L V UH
vore|V UW RRR EH
voss|V AO S
vred|V RRR EH0 D
vredesdom|V RRR EH0 D EH S D UH M
vresig|V RRR EH0 S IH G
vuxen|V UH K S EH N
vy|V Y UW1
väcka|V EH K AE
väderprognos|V EH D EH RRR P RRR AO G N OW0 S
väg|V EH G
vägg|V EH G
vägra|V EH G RRR AE
väl|V EH L
välbehag|V EH L B EH HH AA G
välja|V EH L Y AE
välkommen|V EH L K AO M EH N
vän|V EH N
vänlig|V EH N L IH G
vänta|V EH N T AE
väntan|V EH N T AE N
värd|V EH D
värde|V EH RRR D EH
värdeavi|V EH RRR D EH AE V IY
värden|V AE D EH N
värdera|V EH RRR D EH0 RRR AE
värdighet|V EH RRR D IH G HH EH0 T
värld|V EH RRR D
världen|V AE D EH N
världens|V AE D EH N S
värmlandskorv|V EH RRR M L AE N D S K AO RRR V
värnpliktig|V EH RRR N P L IH K T IH G
värpa|V AE RRR P AE
värva|V AE RRR V AE
väster|V EH S T AH0 RRR
västerås|V EH S T EH RRR OW0 S
västgöte|V EH ER T EH
västgötska|V EH ER T S K AE
västkustskt|V EH S T K UH S T S K T
väte|V EH T EH
väteperoxid|V EH T EH P EH RRR AO K S IY D
växellåda|V EH K S EH L L OW0 D AE
växjö|V EH K OE
växthus|V EH K S T HH UW S
våda|V OW0 D AE
vådlig|V OW0 D L IH G
våg|V OW0 G
vågform|V OW0 G F AO R M
vålnad|V OW0 L N AE D
vång|V AO NG
vår|V OW0 RRR
våradonis|V OW0 RRR AE D UW N IH S
våras|V OW0 RRR AE S
vård|V OW0 D
vårdslös|V OW0 RRR D S L OE S
vårting|V OW0 RRR T IH NG
vårtsvin|V OW0 T S V IY N
våt|V OW0 T
w|W
warszawa|V AE RRR AA V AE
weekend|W IY K EH N D
wiccan|W IH K AE N
wien|V IY N
wiki|W IH K IH
wilsonsimsnäppa|W IH L S AO N S IH M S N EH P AE
xantippa|K S AE N T IH P AE
yngla|NG L AE
yr|Y UW1 RRR
ystad|S T AE D
yttrium|T RRR IH UH M
yvas|Y UW1 V AE S
z|S EH T AE
ziggis|S IH G IH S
zink|S IH N K
zloty|S L AO T
zombie|S AO M B IH
zon|S UW N
zoo|S UW
à|AE
ä|EH
äckelgubbe|EH K EH L G UH B EH
äcklig|EH K L IH G
äga|EH G AE
ägg|EH G
äggakaka|EH G AE K AA K AE
äggtoddy|EH G T AO D
äggula|EH G UW L AE
ägretthäger|EH G RRR EH T HH EH G EH RRR
äldre|EH L D RRR EH
äldst|EH L S T
älg|EH L Y
älgar|EH L Y AE RRR
älling|EH L IH NG
älska|EH L S K AE
älta|EH L T AE
älv|EH L V
älva|EH L V AE
än|EH N
ända|EH N D AE
ändelse|EH N D EH L S EH
ändå|EH N D OW0
äng|EH NG
ängshök|EH NG S HH OE K
ängspiplärka|EH NG S P IY P L EH RRR K AE
änkestöt|EH NG K EH0 S T OE T
ännu|EH N UW
äntligen|EH NG K L IH G EH N
äppeljuice|AE P EH L Y UW S
äppelknyckarbyxa|EH P EH L K N K AE RRR B K S AE
äpple|EH P L EH
äpplen|EH P L EH N
är|EH RRR
ära|AE RRR AE
ärla|EH RRR L AE
ärlig|AE L IH G
ärt|AE T
ät|EH T
äta|EH T AE
äter|EH T RRR
ätt|EH T
äventyrlig|EH V EH N T Y UW1 RRR L IH G
å|AO
åboensisk|OW0 B UH EH N S IH S K
åda|OW0 D AE
åke|OW0 K EH
ål|OW0 L
ålagille|OW0 L AE Y IH L EH
åland|OW0 L AA N D
ångmaskin|AO NG M AE IY N
ångström|AO NG S T RRR ER M
ånyo|AO N Y UW1 UH
år|OW0 RRR
åra|OW0 RRR AE
åren|OW0 RRR EH N
årlig|OW0 L IH G
årta|OW0 R T AE
ås|OW0 S
åsikt|OW0 S IH K T
åskblå|AO S K B L OW0
åstadkomma|OW0 S T AE K AO M AE
åt|OW0 T
åtta|AO T AE
åttio|AO T IH UH
åttonde|AO T AO N D EH
é|EH0
ö|ER
ödem|OE D EH0 M
ödmjukhet|OE D M Y UW K HH EH0 T
öga|OE G AE
ökenlöpare|ER K EH N L OE P AE RRR EH
ökenpipare|OE K EH N P IY P AE R EH
öknamn|ER K N AE M N
öl|OE L
öm|ER M
ömtålig|ER M T OW0 L IH G
ön|OE N
öppen|ER P EH N
öppenhjärtig|ER P EH N Y EH RRR T IH G
öppenhjärtlig|ER P EH N Y EH RRR T L IH G
öra|OE RRR AE
örhänge|OE RRR HH EH NG EH
örn|ER RRR N
örnvinge|OE RRR N V IH NG EH
örnvråk|OE RRR N V RRR OW0 K
öronsäl|OE RRR AO N S EH L
ös|OE S
ösregn|OE S RRR EH NG N
öster|ER S T AH0 RRR
östersjön|OE S T EH RRR OE N
östersund|ER S T EH RRR S UH N D
östgöte|ER ER T EH
östgötska|ER ER T S K AE
över|OE V AE RRR
överflöd|OE V EH RRR F L OE D
ā|EH
ō|ER