a|AE
abacial|AA B AA S IY AE L
abactor|AA B AA K T OW0 R
abade|AA B AE D IH0
abafadamente|AA B AA F AE D AA M T IH0
abaixamento|AA B AE Y SH AA M T UW
abajur|AA B AE ZH UW R
abatimento|AA V AA T IY M T UW
abdicar|AA V DH IY K AE R
abdomes|AE B D AO M EH0 SH
abduzir|AE B D UW Z IY R
abençoado|AA V S W AE DH UW
abjeto|AA B ZH EH T UW
abjeção|AA B ZH EH S AA W
ablaquear|AA B L AA K Y AE RRR
abobadar|AA V UW V AA DH AE R
abobado|AE B OW0 B AE D UW
abominar|AA V UW M IY N AE R
abominação|AA V UW M IY N AA S AA W
abomináveis|AA V UW M IY N AE V EH SH
abominável|AA V UW M IY N AE V EH L
abondança|AA V D AA S AA
aborígene|AA V UW R IY ZH IH0 N IH0
abrandamento|AA V R AA D AA M T UW
abrandar|AA B R AA D AE R
abrangência|AE B R AA ZH S Y AE
abraâmico|AA V R AA AA M IY K UW
abraços|AA V R AE S UW S
abria|AA V R IY AA
abrigado|AA V R IY HH AE DH UW
abrigar|AA B R IY G AE R
abrigo|AA V R IY HH UW
abrindo|AA V R D UW
abrunho|AA V R UW N IY0 UW
abrupto|AA V R UW P T UW
absinto|AA B S T UW
absolutamente|AA B S UW L UW T AA M T IH0
absoluto|AA B S UW L UW T UW
absonância|AE B S OW0 N AA S Y AE
abstenção|AA B SH T S AA W
abstrair|AA V SH T R AA IY R
absurdo|AA B S UW R DH UW
absíntio|AA B S T Y UW
abundância|AA B D AA S Y AA
abusar|AA V UW Z AE R
abóbeda|AA V AO V IH0 DH AA
acabado|AA K AA V AE DH UW
acabando|AA K AA V AA D UW
acabar|AA K AA B AE R
acabava|AA K AA V AE V AA
acabou|AA K AA V OW0 W
academia|AA K AA DH IH0 M IY AA
acalmar|AA K AE L M AE R
acamado|AA K AA M AE DH UW
acanhado|AA K AA N IY0 AE D UW
acarretar|AA K AA RH IH0 T AE R
acartar|AA K AA R T AE R
aceder|AA S IH0 DH EH0 R
aceitar|AA S AA Y T AE R
aceitação|AA S AA Y T AA S AA W
acelerador|AA S IH0 L IH0 R AA DH OW0 R
acelerar|AA S IH0 L IH0 R AE R
acendendo|AA S D D UW
acender|AA S D EH0 R
aceno|AA S EH N UW
acepipe|AE S EH0 P IY P IY
acercar|AA S IH0 R K AE R
acertar|AA S IH0 R T AE R
acerto|AE S EH RH T UW
aceso|AA S EH0 Z UW
acessar|AA S IH0 S AE R
acesso|AA S EH S UW
acetato|AA S IH0 T AE T UW
acha|AE SH AA
acham|AE SH AA W
achaparrado|AE SH AE P AE RH AE D UW
achaparrar|AE SH AE P AE RH AE R
achaque|AA SH AE K IH0
achava|AA SH AE V AA
acho|AE SH UW
acidente|AA S IY D T IH0
aclarar|AA K L AA R AE R
acolhedor|AA K UW L IY IH0 DH OW0 R
acolher|AA K UW L IY EH0 R
acolhimento|AA K UW L IY IY M T UW
aconselhada|AA K S IH0 L IY AE DH AA
aconselhado|AA K S IH0 L IY AE DH UW
aconselhar|AA K S IH0 L IY AE R
acontecimento|AA K T IH0 S IY M T UW
acordado|AA K UW R DH AE DH UW
acossar|AA K UW S AE R
acostar|AA K UW SH T AE R
acostumado|AA K UW SH T UW M AE DH UW
acostumar|AA K UW SH T UW M AE R
acra|AE K R AA
acreditar|AA K R IH0 DH IY T AE R
acrescentar|AA K R IH0 SH S T AE R
acrescentou|AA K R IH0 SH S T OW0 W
acrescer|AA K R IH0 SH S EH0 R
acrograma|AE K R OW0 G R AA M AA
acromático|AA K R UW M AE T IY K UW
acudir|AA K UW DH IY R
acudiu|AA K UW DH IY W
acufeno|AA K UW F EH0 N UW
acurácia|AA K UW RRR AE S Y AA
acusar|AA K UW Z AE R
acúmulo|AA K UW M UW L UW
adaptação|AA DH AA P T AA S AA W
adarga|AA D AE R G AA
adega|AA DH EH HH AA
adelo|AA DH EH L UW
adendo|AE D D UW
adenocarcinoma|AA D EH0 N AO K AA R S IY N OW0 M AA
adenofibroma|AE D EH N AO F IY B R OW0 M AA
adenossarcoma|AA D EH N AO S AA R K OW0 M AA
adenoviral|AA D EH N AO V IY RRR AE L
adenovírus|AA D EH N AO V IY RRR UW SH
adentrar|AE D T R AE RH
adesão|AA DH IH0 Z AA W
adeus|AA DH EH0 W SH
adiantar|AA D Y AA T AE R
adiantou|AA D Y AA T OW0 W
adicionar|AA DH IY S Y UW N AE R
adivinhar|AA DH IY V IY N IY0 AE R
adição|AA D IY S AA W
administrador|AA D M IY N IY SH T R AA D OW0 R
administrar|AA D M IY N IY SH T RRR AE RRR
admirador|AA DH M IY R AA D OW0 R
admirar|AA D M IY R AE R
admiração|AA D M IY R AA S AA W
admitir|AA D M IY T IY R
admoestar|AA D M W EH SH T AE RRR
adoecer|AA DH W EH S EH0 R
adolescência|AA DH UW L IH0 SH S S Y AA
adorar|AA DH UW R AE R
adormecido|AA DH UW R M IH0 S IY DH UW
adornar|AA DH UW R N AE R
adorno|AA DH AO R N UW
adorável|AA DH UW R AE V EH L
adoçar|AA DH UW S AE R
adscrito|AA DH IH0 SH K R IY T UW
aduela|AA D W EH L AA
adufe|AA DH UW F IH0
adular|AA D UW L AE R
adulto|AA DH UW L T UW
advento|AA D V T UW
adverso|AA D V EH R S UW
adversário|AA D V IH0 R S AE R Y UW
adão|AA DH AA W
adélio|AE D EH L Y UW
aeroporto|AA EH R AO P OW0 R T UW
afagar|AA F AA G AE R
afago|AA F AE G UW
afastar|AA F AA SH T AE R
afazendar|AA F AA Z D AE RRR
afeiçoar|AA F AA Y S W AE RRR
afeição|AA F AA Y S AA W
afetar|AA F EH T AE R
afiançar|AA F Y AA S AE R
afigurar|AA F IY G UW R AE R
afinar|AA F IY N AE R
afinidade|AA F IY N IY DH AE DH IH0
afirmar|AA F IY R M AE R
afixar|AA F IY K S AE R
aflita|AA F L IY T AA
aflito|AA F L IY T UW
aflição|AA F L IY S AA W
aflorar|AA F L UW R AE R
afoito|AE F OW0 Y T UW
afrodite|AA F R AO D IY T IH0
afrontar|AA F R T AE R
afugentar|AA F UW ZH T AE R
afundar|AA F D AE R
afável|AA F AE V EH L
agachar|AA G AE SH AE R
agadá|AA HH AA DH AE
agaloar|AA G AA L W AE R
agarrar|AA G AA RH AE RRR
agasalhar|AA HH AA Z AA L IY AE R
agilizar|AA ZH IY L IY Z AE RRR
agiota|AA ZH Y AO T AA
agiotagem|AA ZH Y UW T AE ZH AA Y
agir|AA ZH IY R
agitadamente|AA ZH IY T AE DH AA M T IH0
agitado|AA ZH IY T AE DH UW
agitar|AA ZH IY T AE R
agitação|AA ZH IY T AA S AA W
agoiros|AA HH OW0 Y R UW SH
agonizar|AA G UW N IY Z AE R
agouros|AA HH OW0 W R UW SH
agradar|AA G R AA D AE R
agradara|AA HH R AA DH AE R AA
agradável|AA HH R AA DH AE V EH L
agrafador|AA G R AA F AA D OW0 R
agrafo|AA G R AE F UW
agrupamento|AA HH R UW P AA M T UW
agrupar|AA HH R UW P AE R
aguadeiro|AE G W AA D AA Y R UW
aguante|AA HH W AA T IH0
aguar|AA G W AE R
aguardente|AE HH W AE R DH T IH0
agudo|AA HH UW DH UW
aguerrido|AE G EH0 RH IY D UW
aguça|AA HH UW S AA
aguçar|AA HH UW S AE R
ah|AE
ai|AE Y
aio|AE Y UW
aipim|AE Y P
airoso|AE Y R OW0 Z UW
aja|AE ZH AA
ajoelhar|AA ZH W IH0 L IY AE R
ajuntamento|AA ZH T AA M T UW
ajuntar|AA ZH T AE R
ajustado|AA ZH UW SH T AE DH UW
ajustar|AA ZH UW SH T AE R
ajuste|AA ZH UW SH T IH0
al|AE L
ala|AE L AA
alabarda|AE L AA B AE R DH AA
alambique|AA L AA B IY K IH0
alameda|AA L AA M EH DH AA
alandroal|AA L AA D R UW AE L
alapar|AA L AA P AE R
alar|AA L AE R
alargar|AA L AA R HH AE R
alarve|AA L AE R V IH0
alcaloide|AE L K AA L AO Y D IH0
alcançar|AE L K AA S AE R
alcanço|AE L K AA S UW
alcateia|AE L K AA T AA Y AA
alcatifa|AE L K AA T IY F AA
alcatrão|AE L K AA T R AA W
alcova|AE L K OW0 V AA
alcoólatra|AE L K W AO L AA T R AA
alcunha|AE L K UW N IY0 AA
aldeia|AE L D AA Y AA
aldraba|AE L D R AE V AA
alegação|AA L IH0 HH AA S AA W
alegres|AA L EH HH R IH0 SH
aleijado|AA L AA Y ZH AE DH UW
aleijamento|AA L AA Y ZH AA M T UW
aleijar|AA L AA Y ZH AE R
alenquer|AA L K EH R
alentejo|AA L T EH ZH UW
aleppo|AA L EH P UW
alertamente|AE L EH R T AA M T IH0
alfabetização|AE L F AA V IH0 T IY Z AA S AA W
alfabeto|AE L F AA V EH T UW
alfacinha|AE L F AA S IY N IY0 AA
alfazema|AE L F AA Z EH0 M AA
alfinete|AE L F IY N EH T IY
alfisol|AE L F IY S AO L
alforria|AE L F UW RH IY AA
alforriar|AE L F UW RH Y AA R
algaravia|AE L HH AA R AA V IY AA
algazarra|AE L G AE Z AE RH AA
alghero|AE L G EH R UW
algibeira|AE L ZH IY V AA Y R AA
algum|AE L HH
alguma|AE L HH UW M AA
algumas|AE L HH UW M AA SH
alguns|AE L HH SH
algures|AE L HH UW R IH0 SH
alguém|AE L G AA Y
alho|AE L IY UW
alicerce|AA L IY S EH R S IH0
alijó|AA L IY ZH AO
alinhado|AA L IY N IY0 AE DH UW
alinhamento|AA L IY N IY0 AA M T UW
alinhar|AA L IY N IY0 AE R
alisar|AA L IY Z AE R
aljôfar|AE L ZH OW0 F AE R
almanaque|AE L M AA N AE K IH0
almeida|AE L M EH0 Y DH AA
almodôvar|AE L M UW DH OW0 V AE R
almofada|AE L M UW F AE DH AA
almoçar|AE L M UW S AE R
almude|AE L M UW DH IH0
alongamento|AA L G AA M T UW
alongar|AA L G AE R
alpinismo|AE L P IY N IY ZH M UW
alpinista|AE L P IY N IY SH T AA
altar|AE L T AE R
altear|AE L T Y AE R
alteia|AE L T AA Y AA
altera|AE L T EH R AA
alternado|AE L T IH0 R N AE DH UW
alternar|AE L T IH0 R N AE R
alternativa|AE L T IH0 R N AA T IY V AA
alteza|AE L T EH0 Z AA
altinho|AE L T IY N IY0 UW
altitude|AE L T IY T UW DH IH0
altura|AE L T UW R AA
altão|AE L T AA W
altíssimo|AE L T IY S IY M UW
aluado|AA L W AE DH UW
alucinar|AA L UW S IY N AE R
aludir|AA L UW DH IY R
alugado|AA L UW HH AE DH UW
alugar|AA L UW G AE R
aluguer|AA L UW G EH R
alumiado|AA L UW M Y AE DH UW
alumínico|AA L UW M IY N IY K UW
alvaiázere|AE L V AA Y AE Z IH0 R IH0
alvor|AE L V OW0 R
alvoroço|AE L V UW R AO S UW
alvíssaras|AE L V IY S AA R AA SH
alçar|AE L S AE R
alínea|AA L IY N Y AA
alívio|AA L IY V Y UW
alô|AE L OW0
amado|AA M AE DH UW
amainar|AA M AE Y N AE R
amanhecer|AA M AA N IY0 IH0 S EH0 R
amansador|AA M AA S AA DH OW0 R
amar|AA M AE R
amaral|AA M AA R AE L
amarelar|AA M AA R IH0 L AE R
amares|AA M AE R IH0 SH
amargo|AA M AE R HH UW
amarone|AA M AA R OW0 N IH0
amassar|AA M AA S AE R
amavio|AE M AE V IY UW
amavioso|AE M AE V IY OW0 Z UW
amazonita|AA M AA Z UW N IY T AA
amazonítico|AA M AA Z UW N IY T IY K UW
ambas|AA B AA SH
ambientes|AA B Y T IH0 SH
ambição|AA B IY S AA W
ambos|AA B UW SH
ambulância|AA B UW L AA S Y AA
ambíguo|AA B IY HH W UW
amear|AA M Y AE RRR
ameaça|AA M Y AE S AA
amedrontar|AA M IH0 DH R T AE R
ameia|AA M AA Y AA
ameno|AA M EH0 N UW
ametista|AA M IH0 T IY SH T AA
amieiro|AA M Y AA Y R UW
amiga|AE M IY G AE
amigar|AA M IY HH AE R
amigdalite|AA M IY HH DH AA L IY T IH0
amigável|AA M IY HH AE V EH L
amolar|AA M UW L AE R
amolecer|AA M UW L IH0 S EH0 R
amontoado|AA M T W AE DH UW
amora|AA M AO R AA
amores|AA M OW0 R IH0 SH
amplo|AA P L UW
ampola|AA P OW0 L AA
ampulheta|AA P UW L IY EH0 T AA
amuleto|AA M UW L EH0 T UW
amurca|AA M UW RRR K AA
amável|AA M AE V EH L
américa|AA M EH R IY K AA
analisar|AA N AA L IY Z AE R
ananás|AA N AA N AE SH
anarquia|AE N AE R K IY AA
anca|AA K AA
ancho|AA SH UW
anchova|AA SH OW0 V AA
anchovado|AA SH UW V AE DH UW
anchoveta|AA SH UW V EH0 T AA
ancinho|AA S IY N IY0 UW
ancião|AA S IY AA W
ancora|AA K AO R AA
ancorar|AA K UW R AE R
anda|AA D AA
andaime|AA D AE Y M IH0
andam|AA D AA W
andando|AA D AA D UW
andar|AA D AE R
andava|AA D AE V AA
ando|AA D UW
andou|AA D OW0 W
andrajo|AA D R AE ZH UW
andrajoso|AA D R AE ZH OW0 Z OW0
andressa|AA D R EH0 S AE
andré|AA D R EH
aneurismático|AA N EH0 W R IY ZH M AE T IY K UW
anexo|AA N EH K S UW
anfifílico|AA F IY F IY L IY K UW
angola|AA G AO L AA
anguila|AA G W IY L AA
angular|AA G UW L AE R
anguloso|AA G UW L OW0 Z UW
angústia|AA G UW SH T Y AA
animado|AA N IY M AE DH UW
animar|AA N IY M AE R
anime|AE N IY M EH0
animosidade|AA N IY M UW Z IY DH AE DH IH0
animê|AE N IY M EH0
aninhado|AA N IY N IY0 AE DH UW
aninhar|AA N IY N IY0 AE R
aninho|AA N IY N IY0 UW
aniquilar|AA N IY K IY L AE R
anjo|AA ZH UW
anjos|AA ZH UW SH
anjou|AA ZH UW
anoitecer|AA N OW0 Y T IH0 S EH0 R
anomalia|AA N AO M AA L IY AA
anonimato|AA N AO N IY M AE T UW
anotador|AA N UW T AA DH OW0 R
anotação|AA N UW T AA S AA W
anseio|AA S AA Y UW
ansim|AA S
ansiosamente|AA S Y AO Z AA M T IH0
ansioso|AA S Y OW0 Z UW
ansião|AA S IY AA W
anta|AA T AA
anteato|AA T Y AE T UW
antecâmara|AA T IH0 K AA M AA R AA
antedatar|AA T IH0 D AA T AE R
anteontem|AA T Y T Y
antepassado|AA T IH0 P AA S AE DH UW
antepassados|AA T IH0 P AA S AE DH UW SH
anticultural|AA T IY K UW L T UW R AE L
antifonário|AA T IY F UW N AE R Y UW
antiga|AA T IY HH AA
antigamente|AA T IY HH AA M T IH0
antigos|AA T IY HH UW SH
antimonárquico|AA T IY M UW N AE R K IY K UW
antimoral|AA T IY M UW R AE L
antiquário|AA T IY K W AE R Y UW
antitético|AA T IY T EH T IY K UW
antivacinação|AA T IY V AE S IY N AA S AA W
antontem|AA T T Y
antracífero|AA T R AA S IY F IH0 R UW
antífona|AA T IY F UW N AA
antónimo|AA T AO N IH0 M UW
anuir|AA N W IY R
anuência|AE N UW S Y AE
análise|AA N AE L IY Z IH0
ao|AE W
apagado|AA P AA HH AE DH UW
apaixonado|AA P AE Y SH UW N AE DH UW
apanhar|AA P AA N IY0 AE R
aparafusar|AA P AA R AA F UW Z AE R
aparato|AA P AA R AE T UW
aparatoso|AA P AA R AA T OW0 Z UW
aparece|AA P AA R EH S IH0
aparecer|AA P AA R IH0 S EH0 R
apareceu|AA P AA R IH0 S EH0 W
aparecia|AA P AA R IH0 S IY AA
aparecimento|AA P AA R IH0 S IY M T UW
aparentar|AA P AA R T AE R
aparente|AA P AA R T IH0
aparição|AA P AA R IY S AA W
aparência|AA P AA R S Y AA
apatetado|AE P AE T EH0 T AE D UW
apavorado|AA P AA V UW R AE DH UW
aperrear|AA P IH0 RH Y AE R
apertado|AA P IH0 R T AE DH UW
apertando|AA P IH0 R T AA D UW
apertar|AA P IH0 R T AE R
aperto|AA P EH R T UW
apetite|AA P IH0 T IY T IH0
aplacar|AA P L AA K AE RRR
aplicável|AA P L IY K AE V EH L
apneia|AA P N AA Y AA
apontar|AA P T AE R
aportar|AA P UW R T AE R
aposentar|AA P UW Z T AE R
aposento|AA P UW Z T UW
aposentos|AA P UW Z T UW SH
aprazer|AA P R AA Z EH0 R
aprazível|AA P R AA Z IY V EH L
apreciador|AA P R IH0 S Y AA DH OW0 R
apreciar|AA P R IH0 S Y AE R
aprendiz|AA P R D IY SH
aprendizagem|AA P R D IY Z AE ZH AA Y
apresentado|AA P R IH0 Z T AE DH UW
apresentar|AA P R IH0 Z T AE R
apresentação|AA P R IH0 Z T AA S AA W
apressado|AA P R IH0 S AE DH UW
apressar|AA P R IH0 S AE R
apreço|AA P R EH S UW
aprimorar|AA P R IH0 M UW R AE R
aprofundar|AA P R UW F D AE R
aprontar|AA P R T AE R
apropriado|AA P R UW P R Y AE DH UW
aprovado|AA P R UW V AE DH UW
aprovar|AA P R UW V AE R
aproveitar|AA P R UW V AA Y T AE R
aproximação|AA P R AO S IY M AA S AA W
aproximou|AA P R AO S IY M OW0 W
apurar|AA P UW R AE R
apuro|AE P UW R UW
apócrifo|AA P AO K R IY F UW
apóstolos|AA P AO SH T UW L UW SH
aquendar|AE K W D AE R
aquino|AE K IY N UW
arado|AA R AE DH UW
arando|AA R AA D UW
arau|AA R AE W
araújo|AE R AE UW ZH UW
arbitramento|AA R V IY T R AA M T UW
arborizar|AA R V UW R IY Z AE R
arca|AE R K AA
arcabuz|AE R K AA B UW SH
arcanjo|AA R K AA ZH UW
arcano|AA R K AA N UW
archote|AA R SH AO T IH0
arco|AE R K UW
arder|AA R D EH0 R
ardina|AA R DH IY N AA
ardósia|AE R D AO Z IY AA
ares|AE R IH0 SH
arezzo|AA R EH T IH0 S UW
arganil|AA R HH AA N IY L
argola|AE RH G AO L AE
arguir|AA R G W IY R
argumentador|AA R HH UW M T AA DH OW0 R
argumentar|AA R G UW M T AE R
argumentação|AA R HH UW M T AA S AA W
argumentista|AA R HH UW M T IY SH T AA
argumento|AA R G UW M T UW
arma|AE R M AA
armada|AA R M AE DH AA
armado|AA R M AE DH UW
armador|AA R M AA DH OW0 R
armamar|AA R M AA M AE R
armamentista|AE RH M AE M T SH IY Y SH T AE
armamento|AA R M AA M T UW
armas|AE R M AA SH
armazenar|AA R M AA Z IH0 N AE R
armação|AA R M AA S AA W
arminda|AA R M D AA
armindo|AA R M D UW
armário|AA R M AE R Y UW
arno|AE R N UW
aro|AE R UW
aroma|AA R OW0 M AA
arouca|AA R OW0 W K AA
arpão|AA R P AA W
arqueiro|AE R K AA Y R UW
arquitetura|AA R K IY T EH T UW R AA
arrais|AA RH AE Y SH
arrancar|AA RH AA K AE R
arranjado|AA RH AA ZH AE DH UW
arranjar|AA RH AA ZH AE R
arranjo|AA RH AA ZH UW
arrastado|AA RH AA SH T AE DH UW
arrastando|AA RH AA SH T AA D UW
arrastar|AA RH AA SH T AE R
arrazoar|AA RH AA Z W AE R
arrebentar|AA RH IH0 V T AE R
arrecadar|AA RH IH0 K AA DH AE R
arredores|AA RH IH0 DH AO R IH0 SH
arrefecer|AA RH IH0 F EH S EH0 R
arrefecimento|AA RH IH0 F EH S IY M T UW
arregalar|AA RH IH0 HH AA L AE R
arregimentar|AE RH EH0 ZH IY M T AE RH
arremete|AE RH EH0 M EH T SH IY
arrente|AE RH T IY
arrepender|AA RH IH0 P D EH0 R
arrependido|AA RH IH0 P D IY DH UW
arrependimento|AA RH IH0 P D IY M T UW
arrepiado|AA RH IH0 P Y AE DH UW
arrepiar|AA RH IH0 P Y AE R
arrepio|AA RH IH0 P IY UW
arritmia|AA RH IY T M IY AA
arroba|AA RH OW0 B AA
arrojo|AA RH OW0 ZH UW
arrombar|AA RH B AE R
arronches|AA RH SH IH0 SH
arruaça|AE RH UW AE S AE
arruinar|AA RH UW IY N AE R
arrumar|AA RH UW M AE R
arsenal|AE R S IH0 N AE L
arte|AE R T IH0
artes|AE R T IH0 SH
artificial|AA R T IY F IY S Y AE L
artilharia|AA R T IY L IY AA R IY AA
artista|AA R T IY SH T AA
arvoredos|AA R V UW R EH0 DH UW SH
arábico|AA R AE V IY K UW
asa|AE Z AA
asar|AA Z AE R
asas|AE Z AA SH
ascenso|AA SH S S UW
ascensão|AA SH S S AA W
asfixiar|AA SH F IY K S Y AE R
asilo|AA Z IY L UW
asneira|AA ZH N AA Y R AA
asno|AE ZH N UW
assa|AE S AA
assalariado|AA S AA L AA R Y AE DH UW
assaltar|AA S AE L T AE R
assar|AA S AE R
assassinato|AA S AA S IY N AE T UW
assassínio|AA S AA S IY N Y UW
assear|AA S IH0 AE R
assegurar|AA S IH0 HH UW R AE R
assembleia|AA S B L AA Y AA
assentar|AA S T AE R
asserção|AA S IH0 R S AA W
assessoria|AE S EH0 S OW0 R IY AE
assimilação|AA S IY M IY L AA S AA W
assinalado|AA S IY N AA L AE DH UW
assinalar|AA S IY N AA L AE R
assinar|AA S IY N AE R
assistir|AA S IY SH T IY R
assistência|AA S IY SH T S Y AA
asso|AE S UW
assoalho|AA S W AE L IY UW
assobiar|AA S UW B Y AE RRR
assobio|AA S UW V IY UW
associação|AA S UW S Y AA S AA W
assombrado|AA S B R AE DH UW
assombro|AA S B R UW
assumir|AA S UW M IY R
assunto|AA S T UW
assur|AE S UW R
assustado|AA S UW SH T AE DH UW
assustar|AA S UW SH T AE R
astenia|AE S T EH0 N IY AE
astro|AE S T R UW
astrofísica|AE SH T R AO F IY Z IY K AA
astroso|AA SH T R OW0 Z UW
astúcia|AA SH T UW S Y AA
ata|AE T AA
atado|AA T AE DH UW
atalhar|AA T AA L IY AE R
atarracado|AE T AE RH AE K AE D UW
atarracar|AE T AE RH AE K AE R
atarraxar|AA T AA RH AA SH AE R
atempar|AA T P AE R
ateniense|AA T IH0 N Y S IH0
atentado|AA T T AE DH UW
atenção|AA T S AA W
aterrado|AA T IH0 RH AE DH UW
aterrar|AA T IH0 RH AE R
aterro|AA T EH RH UW
ateísmo|AA T IY IY ZH M UW
atirando|AA T IY R AA D UW
atirou|AA T IY R OW0 W
atitude|AA T IY T UW DH IH0
ativamente|AE T IY V AA M T IH0
ativar|AE T IY V AE R
atividade|AA T IY V IY D AE D IH0
atleta|AA T L EH T AA
atmosfera|AA T M UW SH F EH RRR AA
ato|AE T UW
atraente|AA T R AA T IH0
atrair|AA T R AA IY R
atrapalhada|AA T R AA P AA L IY AE DH AA
atrapalhado|AA T R AA P AA L IY AE DH UW
atrapalhar|AA T R AA P AA L IY AE R
atrasado|AA T R AA Z AE DH UW
atrasar|AA T R AA Z AE R
atraso|AA T R AE Z UW
atravessado|AA T R AA V IH0 S AE DH UW
atravessar|AA T R AA V IH0 S AE R
atração|AA T R AE S AA W
atribular|AA T RRR IY B UW L AE RRR
atrás|AA T R AE SH
atualidade|AA T W AA L IY DH AE DH IH0
atum|AA T
aturo|AE T UW R UW
atómico|AA T AO M IY K UW
audaz|AE W D AE SH
audição|AE W D IY S AA W
aula|AE W L AA
aumentar|AE W M T AE R
aumento|AE W M T UW
aura|AE W R AA
aurora|AE W R AO R AA
aurélio|AE W R EH L Y UW
austeridade|AE W SH T IH0 R IY DH AE DH IH0
austero|AE W SH T EH R UW
ausência|AE W Z S Y AA
autenticidade|AE W T T IY S IY DH AE DH IH0
auto|AE W T UW
autobiográfico|AE W T AO B Y UW G R AE F IY K UW
autocaravana|AE W T AO K AA R AA V AA N AA
autocarro|AE W T AO K AE RH UW
autocolante|AE W T AO K UW L AA T IH0
autoestima|AE W T AO SH T IY M AA
autoestrada|AE W T AO SH T R AE DH AA
autoevidente|AE W T AO IY V IY D T IH0
automatizar|AE W T UW M AA T IY Z AE R
automático|AE W T UW M AE T IY K UW
autora|AE W T OW0 R AA
autoria|AE W T UW R IY AA
autoridade|AE W T UW R IY DH AE DH IH0
autorização|AE W T UW R IY Z AA S AA W
autorretrato|AE W T AO RH IH0 T R AE T UW
auxílio|AE W S IY L Y UW
avaliar|AA V AA L Y AE R
avaliação|AA V AA L Y AA S AA W
avançar|AA V AA S AE R
avariado|AA V AA R Y AE DH UW
ave|AE V EH
avenida|AA V IH0 N IY DH AA
aventurado|AE V T UW R AE D UW
aversão|AA V IH0 R S AA W
aviar|AA V Y AE R
avis|AA V IY SH
avisado|AA V IY Z AE D UW
avisar|AA V IY Z AE R
avistar|AA V IY SH T AE R
avo|AE V UW
avondança|AA V D AA S AA
aya|AE Y AA
azambuja|AA Z AA B UW ZH AA
azar|AA Z AE R
azedo|AA Z EH0 D UW
azeiteiro|AA Z AA Y T AA Y R UW
azereiro|AA Z IH0 R AA Y R UW
azevedo|AA Z IH0 V EH0 DH UW
azia|AA Z IY AA
azinhaga|AA Z IY N IY0 AE HH AA
azo|AE Z UW
azuis|AA Z UW Y SH
azulejo|AA Z UW L EH ZH UW
azulejos|AA Z UW L EH ZH UW SH
açacalar|AA S AA K AA L AE R
açafrão|AA S AA F R AA W
aço|AE S UW
açoite|AA S OW0 Y T IH0
açorda|AA S OW0 R D AA
açougue|AA S OW0 W HH IH0
açucena|AA S UW S EH0 N AA
açude|AA S UW DH IH0
açular|AA S UW L AE R
ação|AE S AA W
açúcar|AA S UW K AA R
açúcares|AA S UW K AA R IH0 SH
aéreo|AA EH R Y UW
babalorixá|B AE B AA L OW0 R IY SH AE
babe|B AE B IY
babosa|B AA V AO Z AA
baboseira|B AE B OW0 Z EH0 Y R AE
bachquir|B AE SH K IY R
bacia|B AA S IY AA
bacu|B AE K UW
badalo|B AA DH AE L UW
bafo|B AE F UW
bagatela|B AE G AE T EH L AE
bagre|B AE HH R IH0
baia|B AE Y AA
baiano|B AE Y AA N UW
bailarina|B AE Y L AA R IY N AA
bailarino|B AE Y L AA R IY N UW
baitar|AE Y
baixa|B AE Y SH AA
baixada|B AA Y SH AE DH AA
baixando|B AE Y SH AA D UW
baixar|B AE Y SH AE R
baixo|B AE Y SH UW
baião|B AE Y AA W
bala|B AE L AA
balada|B AA L AE DH AA
balançar|B AA L AA S AE R
balaço|B AE L AE S UW
baleeiro|B AA L Y AA Y R UW
baliza|B AA L IY Z AA
balzaquiana|B AE L Z AA K Y AA N AA
balázio|B AE L AE Z Y UW
balé|B AE L EH
bamba|B AA B AA
bambo|B AA B UW
bambu|B AA B UW
banca|B AA K AA
bancar|B AA K AE R
banco|B AA K UW
banda|B AA D AA
bandeja|B AA D EH0 ZH AA
bandido|B AA D IY DH UW
bando|B AA D UW
bandolim|B AA D UW L
bangalô|B AA G AA L OW0
banguela|B AA G EH L AA
banhar|B AA N IY0 AE R
banir|B AA N IY R
banza|B AA Z AA
banzo|B AA Z UW
barato|B AA R AE T UW
baraço|B AE R AE S UW
barba|B AE R V AA
barbas|B AE R V AA SH
barbeiro|B AA R V AA Y R UW
barca|B AE R K AA
barco|B AE R K UW
bardo|B AE R D UW
barlavento|B AE R L AA V T UW
barqueiro|B AA R K AA Y R UW
barra|B AE RH AA
barraca|B AA RH AE K AA
barrancos|B AA RH AA K UW SH
barregã|B AA RH IH0 HH AA
barreira|B AA RH AA Y R AA
barreiro|B AA RH AA Y R UW
barriga|B AA RH IY G AA
barrigudo|B AA RH IY G UW D UW
barro|B AE RH UW
barulho|B AA R UW L IY UW
basco|B AE SH K UW
bastar|B AA SH T AE R
bastardo|B AA SH T AE R DH UW
bastidor|B AA SH T IY DH OW0 R
basílica|B AA Z IY L IY K AA
bata|B AE T AA
batel|B AA T EH L
batendo|B AA T D UW
bateu|B AA T EH0 W
batia|B AA T IY AA
batina|B AA T IY N AA
batom|B AE T
bazar|B AA Z AE R
bazófia|B AE Z AO F Y AE
baço|B AE S UW
baú|B AE UW
bebe|B EH B IY
beber|B IH0 V EH0 R
bebida|B IH0 V IY DH AA
bebo|B EH0 B UW
bebé|B EH B EH
beca|B EH K AA
beco|B EH0 K UW
bege|B EH ZH IY
beicinho|B AA Y S IY N IY0 UW
beijos|B AA Y ZH UW SH
beiço|B AA Y S UW
beja|B EH ZH AA
bela|B EH L AA
beladona|B EH L AA D OW0 N AA
belas|B EH L AA SH
beldade|B EH L D AE DH IH0
beleza|B IH0 L EH0 Z AA
belezura|B EH0 L EH0 Z UW R AE
belicista|B EH L IY S IY SH T AA
beliscar|B IH0 L IY SH K AE R
beliz|B IH0 L IY SH
belmonte|B EH L M T IH0
belo|B EH L UW
belos|B EH L UW SH
bemol|B EH0 M AO L
benavente|B IH0 N AA V T IH0
beneficiar|B IH0 N IH0 F IY S Y AE R
benefício|B IH0 N IH0 F IY S Y UW
benesse|B EH0 N EH S IY
bengala|B G AE L AA
bengali|B G AE L IY
benigno|B IH0 N IY HH IH0 N UW
bento|B T UW
benvindo|B Y V D UW
benzeno|B Z EH0 N UW
berlinês|B EH R L IY N EH0 SH
bermuda|B IH0 R M UW DH AA
berça|B EH0 R S AA
berço|B EH0 R S UW
besouro|B IH0 Z OW0 R UW
bestas|B EH0 SH T AA SH
betar|B EH0 T AE R
bete|B EH T SH IY
betinho|B EH T IY N IY0 UW
betume|B IH0 T UW M IH0
bexiga|B IH0 SH IY HH AA
bezerro|B IH0 Z EH0 RH UW
biberão|B IY V IH0 R AA W
bibliógrafo|B IY V L IY AO HH R AA F UW
bicar|B IY K AE R
bicha|B IY SH AA
bicho|B IY SH UW
bicicleta|B IY S IY K L EH T AA
bicla|B IY K L AA
bico|B IY K UW
bicos|B IY K UW SH
bigode|B IY HH AO DH IH0
bigodes|B IY HH AO DH IH0 SH
bigorna|B IY G AO R N AA
bilha|B IY L IY AA
bilhar|B IY L IY AE R
bilhete|B IY L IY EH0 T IH0
bilhetes|B IY L IY EH0 T IH0 SH
bilhão|B IY L IY AA W
bilro|B IY L RH UW
bimba|B B AA
bingo|B G UW
biogeográfico|B IY AO ZH Y UW G R AE F IY K UW
bissau|B IY S AE W
bisu|B IY Z UW
bitaite|B IY T AE Y T IH0
bituca|B IY T UW K AA
bizâncio|B IY Z AA S Y UW
biónico|B Y AO N IY K UW
blenda|B L D AA
blica|B L IY K AA
blocagem|B L OW0 K AE ZH Y
bloco|B L AO K UW
bloquear|B L UW K Y AE R
blusa|B L UW Z AA
boazinha|B OW0 AA Z N IY0 AA
bobinar|B UW V IY N AE R
bobo|B OW0 B UW
boca|B OW0 K AA
bocadinho|B UW K AA DH IY N IY0 UW
bocado|B UW K AE DH UW
bocejar|B UW S IH0 ZH AE R
bocejo|B UW S AA ZH UW
bochicho|B UW SH IY SH UW
boco|B OW0 K UW
bocó|B OW0 K AO
boda|B OW0 DH AA
boi|B OW0 Y
boia|B AO Y AA
boiada|B OW0 Y AE DH AA
boiadeiro|B OW0 Y AA DH AA Y RRR UW
bois|B OW0 Y SH
bola|B AO L AA
boleto|B UW L EH0 T UW
bolha|B OW0 L IY AA
boliche|B UW L IY SH IH0
bolo|B OW0 L UW
bolso|B OW0 L S UW
bolsos|B AO L S UW SH
bom|B
bomba|B B AA
bombeiro|B B AA Y R UW
bombom|B B
bonacheirão|B OW0 N AE SH EH0 Y R AA W
bonachão|B OW0 N AE SH AA W
bondade|B D AE DH IH0
boneca|B UW N EH K AA
bonina|B UW N IY N AA
bonita|B UW N IY T AA
bonito|B UW N IY T UW
boné|B AO N EH
bope|B AO P IY
boquiaberto|B UW K Y AA V EH R T UW
borboletear|B UW R V UW L IH0 T Y AE R
borboletário|B UW R B UW L IH0 T AE R Y UW
bordado|B UW R DH AE DH UW
bordar|B UW R DH AE R
bordo|B AO R DH UW
bordoada|B UW R D UW AE D AA
boro|B AO R UW
boroa|B UW R OW0 AA
borracha|B UW RH AE SH AA
borzeguim|B UW R Z IH0 HH
bosque|B AO SH K IH0
bosão|B AO Z AA W
bota|B AO T AA
botequim|B UW T IH0 K
boticas|B UW T IY K AA SH
boto|B AO T UW
botão|B UW T AA W
botões|B UW T Y SH
bouça|B OW0 W S AA
box|B AO K S
bracelete|B R AE S IH0 L EH T IH0
branca|B R AA K AA
brancas|B R AA K AA SH
branco|B R AA K UW
brancos|B R AA K UW SH
brancura|B R AA K UW R AA
brandamente|B R AA D AA M T IH0
brando|B R AA D UW
brasa|B R AE Z AA
brava|B R AE V AA
bravas|B R AE V AA SH
bravateiro|B R AE V AE T EH0 Y R UW
bravo|B R AE V UW
bravura|B R AA V UW R AA
braça|B R AE S AA
braçada|B R AA S AE DH AA
braço|B R AE S UW
braços|B R AE S UW SH
breca|B R EH K AA
brecha|B R EH SH AA
bregueço|B R EH0 G EH0 S UW
breja|B R EH ZH AE
brejeirar|B RRR EH0 ZH EH0 Y R AE RH
brejeirice|B RRR EH0 ZH EH0 Y R IY S IY
brejeiro|B R EH0 ZH EH0 Y R UW
brejo|B R EH ZH UW
brenha|B R AA Y N IY0 AA
bretão|B R IH0 T AA W
breu|B R EH0 W
breve|B R EH V IH0
brevemente|B R EH V IH0 M T IH0
brida|B R IY DH AA
briga|B R IY G AA
brigada|B R IY HH AE DH AA
brilha|B R IY L IY AA
brilhando|B R IY L IY AA D UW
brilhante|B R IY L IY AA T IH0
brilho|B R IY L IY UW
brincadeira|B R K AA DH AA Y R AA
brinco|B R K UW
brindisi|B R D IY Z IY
brinquedo|B R K EH0 D UW
brisa|B R IY Z AA
brocar|B R UW K AE R
brochura|B R OW0 SH UW R AE
brodo|B R AO D UW
bronze|B R Z IH0
brotar|B R UW T AE R
bruaca|B RRR UW AE K AE
bruco|B R UW K UW
bruges|B R UW ZH IH0 SH
bruma|B R UW M AA
brunir|B R UW N IY R
bruscamente|B R UW SH K AA M T IH0
brusco|B R UW SH K UW
brusqueta|B R UW SH K EH0 T AA
brutalidade|B R UW T AA L IY DH AE DH IH0
bruxa|B R UW SH AA
bucha|B UW SH AA
buchicho|B UW SH IY SH UW
bucólico|B UW K AO L IY K UW
buda|B UW DH AA
buffet|B UW F EH0
bufo|B UW F UW
bufão|B UW F AA W
bufê|B UW F EH0
bugio|B UW ZH IY UW
bula|B UW L AA
bulbo|B UW L B UW
bulhufas|B UW L IY UW F AE S
buliçoso|B UW L IY S OW0 Z UW
bumbum|B B
bunda|B D AA
buque|B UW K IH0
buquê|B UW K EH0
buraco|B UW R AE K UW
burca|B UW R K AA
burgo|B UW R HH UW
buscar|B UW SH K AE R
busão|B UW Z AA W
butão|B UW T AA W
buxo|B UW SH UW
bv|B EH0 V EH0
bácoro|B AE K UW R UW
báculo|B AE K UW L UW
básico|B AE Z IY K UW
bão|B AA W
bélico|B EH L IY K UW
bétula|B EH T UW L AA
bê|B EH0
bênção|B S AA W
bíblia|B IY V L Y AA
bípede|B IY P EH0 D ZH IY
bósnio|B AO SH N IY UW
búlgaro|B UW L G AA R UW
bússola|B UW S UW L AA
búzio|B UW Z Y UW
cabaço|K AE B AE S UW
cabeceira|K AA B IH0 S AA Y R AA
cabeleireiro|K AA V IH0 L AA Y R AA Y R UW
cabelo|K AA V EH0 L UW
cabelos|K AA V EH0 L UW SH
cabide|K AA V IY DH IH0
cabisbaixo|K AE B IY ZH B AE Y SH UW
caca|K AE K AA
cacareco|K AE K AE RRR EH K UW
cachar|K AA SH AE R
cache|K AE SH IH0
cachimbo|K AA SH B UW
cacho|K AE SH UW
cachopa|K AA SH AO P AA
cachopo|K AA SH OW0 P UW
cacimbar|K AA S B AE RRR
caco|K AE K UW
cacofonia|K AA K AO F UW N IY AA
cacto|K AE K T UW
cadeado|K AA DH Y AE DH UW
caderno|K AA DH EH R N UW
cadete|K AA DH EH0 T IH0
caetano|K AA IY T AA N UW
cafofo|K AE F OW0 F UW
cafoto|K AE F OW0 T UW
cafuné|K AE F UW N EH
cai|K AE Y
caia|K AA IY AA
caimão|K AE Y M AA W
caindo|K AA D UW
caio|K AE Y UW
caipira|K AE Y P IY R AA
caixa|K AE Y SH AA
caixilho|K AE Y SH IY L IY UW
caixão|K AE Y SH AA W
cajado|K AA ZH AE DH UW
cala|K AE L AA
calais|K AE L EH
calam|K AE L AA W
calcada|K AE L K AE DH AA
calcado|K AE L K AE DH UW
calcanhar|K AE L K AA N IY0 AE R
calcar|K AE L K AE R
calculação|K AE L K UW L AA S AA W
caldeirão|K AE L DH AA Y R AA W
calebe|K AE L EH B IY
calha|K AE L IY AA
calhambeque|K AA L IY AA B EH K IH0
calhar|K AA L IY AE R
calheta|K AA L IY EH0 T AA
calibre|K AA L IY B R IH0
califa|K AA L IY F AA
caligrafia|K AA L IY HH R AA F IY AA
calistenia|K AE L IY S T EH0 N IY AE
calo|K AE L UW
calorento|K AA L UW R T UW
caloroso|K AA L UW R OW0 Z UW
calão|K AA L AA W
calçada|K AE L S AE DH AA
calçado|K AE L S AE DH UW
calçar|K AE L S AE R
calças|K AE L S AA SH
camada|K AA M AE DH AA
camarada|K AA M AA R AE D AA
cambalhota|K AA B AA L IY AO T AA
camboja|K AA B AO ZH AA
cambé|K AA B EH
camelódromo|K AE M EH0 L AO D R OW0 M UW
camelô|K AE M EH0 L OW0
caminha|K AA M IY N IY0 AA
caminhada|K AA M IY N IY0 AE D AA
caminhando|K AA M IY N IY0 AA D UW
caminhar|K AA M IY N IY0 AE R
caminhos|K AA M IY N IY0 UW SH
camisa|K AA M IY Z AA
camisola|K AA M IY Z AO L AA
camião|K AE M Y AA W
camoniano|K AE M UW N Y AA N UW
campa|K AA P AA
campainha|K AA P AA IY N IY0 AA
campanário|K AA P AA N AE R Y UW
campesino|K AA P IH0 Z IY N UW
campestre|K AA P EH SH T R IH0
campo|K AA P UW
campos|K AA P UW SH
camurça|K AA M UW R S AA
canaque|K AA N AE K IH0
canavês|K AA N AA V EH0 SH
cancela|K AA S EH L AA
cancioneiro|K AA S Y UW N AA Y R UW
cancro|K AA K R UW
candango|K AA D AA G UW
candeeiro|K AA D Y AA Y R UW
candela|K AA D EH L AA
candidato|K AA D IY DH AE T UW
candil|K AA D IY L
candomblé|K AA D B L EH
candonga|K AA D G AA
canga|K AA G AA
cangambá|K AA G AA B AE
canguru|K AA G UW R UW
canivete|K AA N IY V EH T EH0
canja|K AA ZH AA
canoa|K AA N OW0 AA
cansa|K AA S AA
cansado|K AA S AE DH UW
cansar|K AA S AE R
cansaço|K AA S AE S UW
canseira|K AA S EH0 Y R AE
canso|K AA S UW
canta|K AA T AA
cantador|K AA T AA DH OW0 R
canteiro|K AA T AA Y R UW
cantiga|K AA T IY HH AA
cantina|K AA T IY N AA
canto|K AA T UW
cantor|K AA T OW0 R
cantos|K AA T UW SH
cantão|K AA T AA W
canudo|K AA N UW DH UW
canário|K AA N AE R Y UW
canção|K AA S AA W
canções|K AA S Y SH
caos|K AE W SH
capa|K AE P AA
capacidade|K AA P AA S IY DH AE DH IH0
capacitar|K AA P AA S IY T AE R
capelão|K AA P IH0 L AA W
capicua|K AA P IY K UW AA
capitais|K AA P IY T AE IY SH
capitão|K AA P IY T AA W
capoeirista|K AA P W AA Y R IY S T AA
caprichar|K AE P R IY SH AE RRR
capricho|K AA P R IY SH UW
capturar|K AE P T UW R AE R
capturo|K AE P T UW R UW
capucho|K AA P UW SH UW
caput|K AE P UW T
capuz|K AA P UW SH
cara|K AE R AA
caraminhola|K AE R AE M IY Y AO L AE
carapaça|K AA R AA P AE S AA
caravela|K AA R AA V EH L AA
carcanhol|K AA R K AA N IY0 AO L
carcaça|K AA R K AE S AA
cardiff|K AE R D IY F IH0
carga|K AE R HH AA
cargo|K AE R HH UW
carica|K AA RRR IY K AA
caridade|K AA R IY DH AE DH IH0
carimbar|K AA R B AE R
carimbo|K AA R B UW
carnificina|K AA R N IY F IY S IY N AA
carniça|K AA R N IY S AA
caro|K AE R UW
carola|K AE R AO L AE
caroça|K AA R AO S AA
carpete|K AE R P EH T IH0
carpideira|K AA R P IY DH AA Y R AA
carpir|K AA R P IY R
carranca|K AA RH AA K AA
carrapato|K AA RH AA P AE T UW
carrapicho|K AE RH AE P IY SH UW
carrasco|K AA RH AE SH K UW
carregado|K AA RH IH0 HH AE DH UW
carregar|K AA RH IH0 G AE R
carreira|K AA RH AA Y R AA
carreiro|K AA RH AA Y R UW
carreta|K AA RH EH0 T AA
carrilhão|K AA RH IY L IY AA W
carro|K AE RH UW
carros|K AE RH UW SH
carroça|K AA RH AO S AA
carruagem|K AA RH W AE ZH AA Y
cartas|K AE R T AA SH
cartaxo|K AA R T AE SH UW
cartaz|K AA R T AE SH
carteiro|K AA R T AA Y R UW
cartune|K AE R T
cará|K AA R AE
carão|K AA R AA W
carícia|K AA R IY S Y AA
casa|K AE Z AA
casaco|K AA Z AE K UW
casam|K AE Z AA W
casamento|K AA Z AA M T UW
casario|K AA Z AA R IY UW
cascata|K AA SH K AE T AA
casco|K AE SH K UW
caseiro|K AA Z AA Y R UW
caserna|K AA Z EH R N AA
casino|K AA Z IY N UW
caso|K AE Z UW
casos|K AE Z UW SH
casota|K AA Z AO T AA
caspa|K AE SH P AA
cassetete|K AE S IH0 T EH T IH0
castelo|K AA SH T EH L UW
castidade|K AA SH T IH0 DH AE DH IH0
castigar|K AA SH T IY HH AE R
castigo|K AA SH T IY HH UW
casto|K AE SH T UW
castrejo|K AA SH T R AA Y ZH UW
castroverde|K AE SH T R UW V EH0 R D IH0
casula|K AA Z UW L AA
cata|K AE T AA
catafalco|K AA T AA F AE L K UW
catam|K AE T AA W
cataplana|K AA T AA P L AA N AA
catapúcia|K AE T AE P UW S Y AE
catarse|K AA T AE R S IH0
catequista|K AE T EH0 K IY S T AE
catita|K AA T IY T AA
cativar|K AA T IY V AE R
cativo|K AA T IY V UW
cato|K AE T UW
catraio|K AA T R AE Y UW
catástrofe|K AA T AE SH T R UW F IH0
causa|K AE W Z AA
causo|K AE W Z UW
cauto|K AE W T UW
cauã|K AE W AA
cauê|K AE W EH0
cava|K AE V AA
cavalaria|K AA V AA L AA R IY AA
cavalos|K AA V AE L UW SH
cavaquinho|K AA V AA K IY N IY0 UW
caviar|K AE V Y AE R
caxumba|K AA SH B AA
caça|K AE S AA
caço|K AE S UW
caô|K AE OW0
ceco|S EH K UW
cedro|S EH DH R UW
cegonha|S IH0 HH OW0 N IY0 AA
cegueta|S EH0 G EH0 T AE
ceifa|S AA Y F AA
ceifar|S AA Y F AE R
cela|S EH L AA
celeiro|S IH0 L AA Y R UW
celeste|S IH0 L EH SH T IH0
celestial|S IH0 L IH0 SH T Y AE L
celeuma|S IH0 L EH0 W M AA
celibato|S IH0 L IY V AE T UW
cenoira|S IH0 N OW0 Y R AA
cenrada|S RH AE DH AA
censo|S S UW
censura|S S UW R AA
censurai|S S UW R AE Y
censuram|S S UW R AA W
censurando|S S UW R AA D UW
censurara|S S UW R AE R AA
censurava|S S UW R AE V AA
censuro|S S UW R UW
centauro|S T AE W R UW
centavo|S T AE V UW
cento|S T UW
centopeia|S T UW P AA Y AA
centro|S T R UW
centrípeto|S T R IY P EH0 T UW
centímetro|S T IY M IH0 T R UW
cepo|S EH0 P UW
cera|S EH0 R AA
cerca|S EH0 R K AA
cereal|S IH0 R Y AE L
cereja|S EH R EH0 ZH AE
cerrar|S IH0 RH AE R
certamente|S EH R T AA M T IH0
certeza|S IH0 R T EH0 Z AA
certinho|S EH R T IY N IY0 UW
certíssimo|S EH R T IY S IY M UW
cervo|S EH R V UW
cessa|S EH S AA
cessar|S IH0 S AE R
cesto|S EH0 SH T UW
cetro|S EH T R UW
ceuta|S EH0 W T AA
cevar|S IH0 V AE R
chacina|SH AE S IY N AE
chacra|SH AE K R AA
chada|SH AE D AA
chafariz|SH AA F AA R IY SH
chafurdar|SH AA F UW R DH AE R
chaleira|SH AA L AA Y R AA
chamado|SH AA M AE DH UW
chamava|SH AA M AE V AA
chamejar|SH AA M EH0 ZH AE R
chaminé|SH AA M IY N EH
champanha|SH AA P AA N IY0 AA
champô|SH AA P OW0
chamusca|SH AA M UW SH K AA
chamuscar|SH AA M UW SH K AE R
chantagem|SH AA T AE ZH AA Y
chapa|SH AE P AA
charamela|SH AA R AA M EH L AA
charco|SH AE R K UW
charque|SH AE R K IH0
charrete|SH AE RH EH T SH IY
chasco|SH AE SH K UW
chatear|SH AA T Y AE R
chato|SH AE T UW
chau|SH AE W
chaves|SH AE V IH0 SH
chavo|SH AE V UW
chavão|SH AE V AA W
checa|SH EH K AA
checagem|SH EH0 K AE ZH
chefia|SH IH0 F IY AA
chefículo|SH EH F IY K UW L UW
chega|SH EH0 HH AA
chegada|SH IH0 HH AE DH AA
chegado|SH IH0 HH AE DH UW
chegando|SH IH0 HH AA D UW
chegara|SH IH0 HH AE R AA
chegará|SH IH0 HH AA R AE
chegava|SH IH0 HH AE V AA
chegou|SH IH0 HH OW0 W
cheia|SH AA Y AA
cheias|SH AA Y AA SH
cheios|SH AA Y UW SH
cheirar|SH AA Y R AE R
cheiro|SH AA Y R UW
cheque|SH EH K IH0
chernobil|SH IH0 R N UW B IY L
chiar|SH Y AE R
chiaroscuro|K Y AE R UW SH K UW R UW
chibata|SH IY B AE T AE
chibo|SH IY V UW
chicho|SH IY SH UW
chico|SH IY K UW
chicotada|SH IY K UW T AE DH AA
chicote|SH IY K AO T IH0
chicotear|SH IY K UW T Y AE R
chifre|SH IY F R IH0
chila|SH IY L AA
chimpanzé|SH P AA Z EH
chimpar|SH P AE R
china|SH IY N AA
chinela|SH IY N EH L AA
chinelas|SH IY N EH L AA SH
chinelo|SH IY N EH L UW
chinelos|SH IY N EH L UW SH
chinfrim|SH F R
chinês|SH IY N EH0 SH
chiqueiro|SH IY K AA Y R UW
chisa|SH IY Z AA
chita|SH IY T AA
choca|SH AO K AA
chocalho|SH UW K AE L IY UW
chocar|SH UW K AE R
chocho|SH OW0 SH UW
choco|SH OW0 K UW
choldra|SH AO L D R AA
chor|SH OW0 R
chorando|SH UW R AA D UW
chorar|SH UW R AE R
chorinho|SH UW RRR IY N IY0 UW
choro|SH AO R UW
chororô|SH OW0 R OW0 R OW0
choupana|SH OW0 W P AA N AA
choupo|SH OW0 W P UW
chouriço|SH OW0 W R IY S UW
chouseira|SH OW0 W Z AA Y R AA
chousura|SH OW0 W Z UW R AA
chuca|SH UW K AE
chufa|SH UW F AA
chufando|SH UW F AA D UW
chufara|SH UW F AE R AA
chuiva|SH UW Y V AA
chulca|SH UW W K AE
chulipa|SH UW L IY P AA
chulo|SH UW L UW
chulé|SH UW L EH
chumaço|SH UW M AE S UW
chumbaram|SH B AE R AA W
chumbo|SH B UW
chupar|SH UW P AE R
chupeta|SH UW P EH0 T AA
chupim|SH UW P
chutar|SH UW T AE R
chuto|SH UW T UW
chuva|SH UW V AA
chuveiro|SH UW V AA Y R UW
chuvoso|SH UW V OW0 Z UW
chuço|SH UW S UW
chá|SH AE
chádico|SH AE DH IY K UW
chávena|SH AE V IH0 N AA
chã|SH AA
chão|SH AA W
ciclo|S IY K L UW
cientista|S Y T IY SH T AA
científico|S Y T IY F IY K UW
cifra|S IY F R AA
cifrão|S IY F R AA W
cilha|S IY L IY AA
cilindrar|S IH0 L D R AE R
cimenta|S IY M T AA
cimento|S IY M T UW
cimitarra|S IY M IH0 T AE RH AA
cinamomo|S IY N AA M OW0 M UW
cinco|S K UW
cinfães|S F AA Y SH
cinquenta|S K W T AA
cinto|S T UW
cintura|S T UW R AA
cinturão|S T UW R AA W
cinza|S Z AA
cinzento|S Z T UW
cio|S IY UW
cipozão|S IY P AO Z AA W
cipreste|S IY P R EH SH T IH0
cipó|S IY P AO
circatejano|S IY R K AA T IH0 ZH AA N UW
circumpolar|S IY R K P UW L AE R
circuncentro|S IY RRR K S T RRR UW
circundar|S IY R K D AE R
circunferência|S IY R K F IH0 R S Y AA
circunlóquio|S IY R K L AO K Y UW
circunscrição|S IY R K SH K R IY S AA W
circunspecto|S IY R K SH P EH T UW
circunstanciar|S IY R K SH T AA S Y AE R
cirurgia|S IY R UW R ZH IY AA
cirurgião|S IY R UW R ZH Y AA W
cisco|S IY SH K UW
cismar|S IY ZH M AE R
cisne|S IY ZH N IH0
cisterna|S IY SH T EH R N AA
cisto|S IY SH T UW
citadino|S IY T AA DH IY N UW
citado|S IY T AE D UW
citar|S IY T AE R
citarista|S IY T AA R IY SH T AA
citação|S IY T AA S AA W
citrino|S IY T RRR IY N UW
civeta|S IY V EH0 T AA
civilizado|S IH0 V IH0 L IY Z AE DH UW
civilização|S IH0 V IH0 L IY Z AA S AA W
clandestino|K L AA D IH0 SH T IY N UW
clara|K L AE R AA
claridade|K L AA R IY DH AE DH IH0
claro|K L AE R UW
claros|K L AE R UW SH
clarão|K L AA R AA W
claustro|K L AE W SH T R UW
clausura|K L AE W Z UW R AA
clava|K L AE V AA
clemente|K L IH0 M T IH0
clero|K L EH R UW
clima|K L IY M AA
climatérico|K L IY M AA T EH R IY K UW
clio|K L IY UW
cloro|K L AO R UW
clube|K L UW V IH0
clássico|K L AE S IY K UW
clã|K L AA
clérigo|K L EH R IY HH UW
clínica|K L IY N IY K AA
clínico|K L IY N IY K UW
coador|K W AA DH OW0 R
coaxar|K W AA SH AE R
coberta|K UW V EH R T AA
cobertas|K UW V EH R T AA SH
coberto|K UW B EH R T UW
cobertor|K UW V IH0 R T OW0 R
cobiça|K UW V IY S AA
cobiçar|K UW B IY S AE R
cobra|K AO V R AA
cobrar|K UW V R AE R
cobria|K UW V R IY AA
cobrir|K UW V R IY R
cocheira|K UW SH AA Y R AA
cocheiro|K UW SH AA Y R UW
cochicho|K UW SH IY SH UW
cochinchina|K UW SH SH IY N AA
coclear|K UW K L Y AE R
coco|K OW0 K UW
cocota|K OW0 K OW0 T AE
cogumelo|K UW HH UW M EH L UW
coima|K OW0 Y M AA
coincidir|K W S IY D IY R
coincidência|K W S IY D S Y AA
coiote|K AO Y AO T IH0
coisa|K OW0 Y Z AA
coitada|K OW0 Y T AE DH AA
coitado|K OW0 Y T AE DH UW
coitar|K OW0 Y T AE R
cola|K AO L AA
colaboração|K UW L AA B UW R AA S AA W
colar|K UW L AE R
colarinho|K UW L AA R IY N IY0 UW
colcha|K OW0 L SH AA
colchão|K UW L SH AA W
colega|K UW L EH HH AA
coleira|K UW L AA Y R AA
colesterol|K AO L IH0 SH T IH0 R AO L
colher|K UW L IY EH R
colhão|K UW L IY AA W
colo|K AO L UW
colonização|K UW L UW N IY Z AA S AA W
colorido|K UW L UW R IY DH UW
colorir|K UW L UW R IY R
colégio|K UW L EH ZH Y UW
comadre|K UW M AE DH R IH0
comandar|K UW M AA D AE R
comando|K UW M AA D UW
combatente|K B AA T T IH0
combinado|K B IY N AE DH UW
combinados|K B IY N AE DH UW
combinar|K B IY N AE R
combinação|K B IY N AA S AA W
comemorar|K UW M IH0 M UW R AE R
comercializar|K UW M IH0 R S Y AE L IY Z AE R
começar|K UW M IH0 S AE R
começava|K UW M IH0 S AE V AA
começo|K AO M EH0 S UW
começou|K UW M IH0 S OW0 W
comilão|K UW M IY L AA W
comissário|K UW M IY S AE R Y UW
comissão|K UW M IY S AA W
comité|K AO M IY T EH
comover|K UW M UW V EH0 R
comovido|K UW M UW V IY DH UW
comoção|K UW M UW S AA W
compaixão|K P AE Y SH AA W
companha|K P AA N IY0 AA
companhia|K P AA N IY0 IY AA
comparar|K P AA R AE R
comparativo|K P AA R AA T IY V UW
comparação|K P AA R AA S AA W
comparável|K P AA R AE V EH L
compasso|K P AE S UW
compatriota|K P AA T R Y AO T AA
compensa|K P S AA
compensai|K P S AE Y
compensam|K P S AA W
compensando|K P S AA D UW
compensara|K P S AE R AA
compensaram|K P S AE R AA W
compensava|K P S AE V AA
compensavam|K P S AE V AA W
compenso|K P S UW
compensou|K P S OW0 W
competia|K P IH0 T IY AA
competidor|K P IH0 T IY DH OW0 R
competir|K P IH0 T IY R
competição|K P IH0 T IY S AA W
competência|K P IH0 T S Y AA
compilação|K P IY L AA S AA W
compincha|K P SH AA
complemento|K P L IH0 M T UW
completar|K P L IH0 T AE R
completo|K P L EH T UW
complexar|K P L EH K S AA R
complô|K P L OW0
comportamento|K P UW R T AA M T UW
comportar|K P UW R T AE R
compota|K P AO T AA
compra|K P R AA
comprai|K P R AE Y
comprando|K P R AA D UW
comprara|K P R AE R AA
comprava|K P R AE V AA
compreende|K P R Y D IH0
compreender|K P R Y D EH0 R
compreensão|K P R Y S AA W
compressa|K P R EH S AA
comprido|K P R IY DH UW
comprimento|K P R IY M T UW
compro|K P R UW
compromete|K P R OW0 M EH T SH IY
compromisso|K P R UW M IY S UW
computa|K P UW T AA
computador|K M P UW T AA DH OW0 R
computando|K P UW T AA D UW
computara|K P UW T AE R AA
computava|K P UW T AE V AA
computo|K P UW T UW
compêndio|K P D Y UW
comunicado|K UW M UW N IY K AE DH UW
comunicar|K UW M UW N IY K AE R
comunicação|K UW M UW N IY K AA S AA W
comunismo|K AO M UW N IY ZH M UW
comunista|K UW M UW N IY SH T AA
comédia|K UW M EH DH Y AA
comércio|K UW M EH R S Y UW
conceder|K S IH0 DH EH0 R
conceição|K S AA Y S AA W
concelho|K S AA L IY UW
concha|K SH AE
conciliar|K S IY L Y AE R
concitador|K S IY T AA DH OW0 R
conclusivo|K K L UW Z IY V UW
conclusão|K K L UW Z AA W
concordar|K K UW R DH AE R
concorrência|K K UW RH S Y AA
concretizar|K K R IH0 T IY Z AE R
concreto|K K R EH T UW
conde|K D IH0
condensação|K D S AA S AA W
condessa|K D EH0 S AA
condimentar|K D IY M T AE R
condizer|K D IY Z EH0 R
condição|K D IY S AA W
conduta|K D UW T AA
conduzir|K D UW Z IY R
condução|K D UW S AA W
condão|K D AA W
conectar|K UW N EH K T AE R
confederação|K F IH0 DH IH0 R AA S AA W
confeição|K F AA Y S AA W
confessa|K F EH S AA
confessar|K F IH0 S AE R
confiar|K F Y AE R
confidência|K F IY DH S Y AA
configuração|K F IY G UW R AA S AA W
configuro|K F IY G UW R UW
confinar|K F IY N AE R
confissão|K F IY S AA W
confortar|K F UW R T AE R
conforto|K F AO R T UW
confortável|K F UW R T AE V EH L
confrontar|K F RRR T AE R
confuso|K F UW Z UW
confusão|K F UW Z AA W
congratulou|K G R AE T UW L OW0 W
congregação|K G R IH0 HH AA S AA W
congressista|K G R IH0 S IY SH T AA
congresso|K G R EH S UW
congro|K G R UW
congruência|K G R W S Y AA
conhaque|K AO N IY0 AE K IH0
conhecedor|K UW N IY0 IH0 S IH0 DH OW0 R
conhecia|K UW N IY0 IH0 S IY AA
conhecida|K UW N IY0 IH0 S IY DH AA
conhecimento|K UW N IY0 IH0 S IY M T UW
conjunto|K ZH T UW
conjuro|K ZH UW R UW
conquista|K K IY SH T AA
conquistas|K K IY SH T AA SH
consagrar|K S AA HH R AE R
consciente|K SH S Y T IH0
consciência|K SH S Y S Y AA
conseguinte|K S EH0 G T IY
conselheiro|K S IH0 L IY AA Y R UW
conselho|K S AA Y L IY UW
consentimento|K S T IY M T UW
consentir|K S T IY R
consequência|K S IH0 K W S Y AA
consertar|K S IH0 R T AE R
conserva|K S EH R V AA
conservava|K S IH0 R V AE V AA
consistir|K S IY SH T IY R
consoada|K S W AE DH AA
consoante|K S W AA T IH0
consolar|K S UW L AE R
consolação|K S UW L AA S AA W
consolo|K S AO L UW
conspícuo|K SH P IY K W UW
constante|K SH T AA T IH0
constança|K SH T AA S AA
constatação|K SH T AA T AA S AA W
constipação|K SH T IY P AA S AA W
constituir|K SH T IY T W IY R
constrangimento|K S T RRR AA ZH IY M T UW
construir|K SH T R UW IY R
construtor|K SH T R UW T OW0 R
construção|K SH T R UW S AA W
constância|K SH T AA S Y AA
consulado|K S UW L AE DH UW
consular|K S UW L AE R
consulesa|K S UW L EH0 Z AA
consultar|K S UW L T AE R
consultório|K S UW L T AO R Y UW
consumir|K S UW M IY R
consumo|K S UW M UW
conta|K T AA
contactar|K T AA K T AE R
contacto|K T AE K T UW
contagem|K T AE ZH AA Y
contai|K T AE Y
contam|K T AA W
contando|K T AA D UW
contanto|K T AA T UW
contara|K T AE R AA
contaram|K T AE R AA W
contatar|K T AA T AE RRR
contava|K T AE V AA
contavam|K T AE V AA W
contentar|K T T AE R
contente|K T T IH0
contentor|K T T OW0 R
conter|K T EH0 R
conteúdo|K T Y UW DH UW
contingenciamento|K T ZH S Y AE M T UW
contino|K T IY N UW
continua|K T IY N UW AA
continuamente|K T IY N W AA M T IH0
continuar|K T IY N W AE R
continuava|K T IY N W AE V AA
continuou|K T IY N W OW0 W
conto|K T UW
contornar|K T UW R N AE R
contorno|K T OW0 R N UW
contos|K T UW SH
contou|K T OW0 W
contra|K T R AA
contrabaixo|K T RRR AA B AE Y SH UW
contramestre|K T R AA M EH SH T R IH0
contramão|K T R AE M AA W
contrariar|K T R AA R Y AE R
contratar|K T R AA T AE R
contrato|K T R AE T UW
contribuição|K T R IY V W IY S AA W
controlador|K T R UW L AA D OW0 R
controlar|K T RRR UW L AE RRR
controlo|K T R AO L UW
contrário|K T R AE R Y UW
contínuo|K T IY N W UW
convencer|K V S EH0 R
convento|K V T UW
convenção|K V S AA W
conversa|K V EH R S AA
conversando|K V IH0 R S AA D UW
conversar|K V IH0 R S AE R
convexo|K V EH K S UW
convicção|K V IY K S AA W
conviva|K V IY V AA
conviver|K V IY V EH0 RRR
convés|K V EH SH
cookie|K UW K IY
coorte|K W AO R T IH0
copa|K AO P AA
copeiro|K OW0 P EH0 Y R UW
copla|K AO P L AA
copo|K AO P UW
copta|K AO P T AA
coquete|K OW0 K EH T SH IY
coragem|K UW R AE ZH AA Y
corajoso|K UW R AA ZH OW0 Z UW
corações|K UW R AA S Y SH
cordas|K AO R D AA SH
cordilheira|K UW R DH IY L IY AA Y R AA
cordão|K UW R DH AA W
cordões|K UW R DH Y SH
coreia|K UW RRR AA Y AA
cores|K OW0 R IH0 SH
corintiano|K OW0 R T SH IY AA N UW
cornalina|K OW0 R N AA L IY N AA
corno|K OW0 R N UW
coro|K AO R UW
corolário|K UW R UW L AE R Y UW
coros|K AO R UW SH
corporal|K UW R P UW R AE L
corredor|K UW RH IH0 DH OW0 R
correia|K UW RH AA Y AA
corrente|K UW RH T IH0
corresponder|K UW RH IH0 SH P D EH0 R
correspondência|K UW RH IH0 SH P D S Y AA
corretamente|K UW RH EH T AA M T IH0
corrida|K UW RH IY DH AA
corrimão|K UW RH IY M AA W
corroboração|K UW RH UW V UW R AA S AA W
corrupio|K UW RH UW P IY UW
corrupto|K UW RH UW P T UW
corrupção|K UW RH UW P S AA W
cortado|K UW R T AE DH UW
cortando|K UW R T AA D UW
cortiça|K UW R T IY S AA
coruche|K UW R UW SH IH0
coruja|K UW R UW ZH AA
corça|K AO R S AA
coró|K OW0 R AO
coser|K UW Z EH0 RRR
cosseno|K UW S EH0 N UW
costa|K AO SH T AA
costumar|K UW SH T UW M AE R
costumava|K UW SH T UW M AE V AA
costume|K UW SH T UW M IH0
cota|K AO T AA
cotangente|K OW0 T AA ZH T IH0
cotiano|K OW0 T SH IY AA N UW
cotovia|K UW T UW V IY AA
couraçado|K OW0 W R AA S AE DH UW
couro|K OW0 W R UW
cousa|K OW0 W Z AA
couto|K OW0 W T UW
cova|K AO V AA
coveiro|K AO V AA Y R UW
covo|K OW0 V UW
coxa|K OW0 SH AA
coxo|K OW0 SH UW
cozido|K UW Z IY DH UW
cozinhar|K UW Z IY N IY0 AE R
cozinheiro|K UW Z IY N IY0 AA Y R UW
coçar|K UW S AE R
crasso|K R AE S UW
crato|K R AE T UW
crau|K R AE W
crava|K R AE V AA
cravejado|K R AA V IH0 ZH AE DH UW
cravo|K R AE V UW
creditar|K R IH0 DH IY T AE R
credo|K R EH DH UW
credor|K R EH DH OW0 R
credulidade|K R EH DH UW L IY DH AE DH IH0
crença|K R S AA
creolina|K R EH0 W L IY N AA
crepe|K R EH P IY
crepes|K R EH P IY SH
crescer|K R IH0 SH S EH0 R
crescido|K R IH0 SH S IY DH UW
crescimento|K R IH0 SH S IY M T UW
creta|K R EH T AA
creu|K R EH0 W
cri|K R IY
criada|K R Y AE DH AA
criados|K R IY AE DH UW SH
criança|K R IY AA S AA
crianças|K R IY AA S AA SH
criar|K R IY AE R
criatura|K R IY AA T UW R AA
crica|K R IY K AE
cricri|K R IY K R IY
crime|K R IY M IH0
criminoso|K R IY M IY N OW0 Z UW
crio|K R IY UW
criptido|K R IY P T SH IY D OW0
criptídeo|K R IY P T SH IY D ZH IY UW
crise|K R IY Z IH0
crisol|K R IY Z AO L
crista|K R IY SH T AA
cristalizar|K R IY SH T AA L IY Z AE R
cristalização|K R IY SH T AA L IY Z AA S AA W
cristiano|K R IY SH T Y AA N UW
cristo|K R IY SH T UW
criticar|K R IY T IY K AE R
crocodilo|K R OW0 K UW DH IY L UW
cromático|K RRR AO M AE T IY K UW
croquete|K RRR AO K EH T IH0
cru|K R UW
crueldade|K R UW EH L D AE DH IH0
cruzada|K R UW Z AE D AA
cruzado|K R UW Z AE DH UW
cruzados|K R UW Z AE DH UW SH
cruzeta|K R UW Z EH0 T AA
crápula|K R AE P UW L AE
crédito|K R EH DH IY T UW
créu|K R EH W
crê|K R EH0
crítico|K R IY T IY K UW
cu|K UW
cuba|K UW V AA
cubicar|K UW V IY K AE R
cuca|K UW K AA
cuecas|K W EH K AA SH
cuia|K UW Y AA
cuidado|K W IY DH AE DH UW
cuidar|K UW Y DH AE R
cuja|K UW ZH AA
cujo|K UW ZH UW
cujos|K UW ZH UW SH
culpa|K UW L P AA
culposamente|K UW L P OW0 Z AA M T IH0
cultura|K UW L T UW R AA
cume|K UW M IH0
cumprimento|K P R IY M T UW
cumprir|K P RRR IY RRR
cuneta|K UW N EH0 T AE
cupim|K UW P
cupincha|K UW P SH AA
cupom|K UW P
cupão|K UW P AA W
curação|K UW R AA S AA W
curcuma|K UW R K UW M AA
curimã|K UW R IY M AA
curinga|K UW R G AA
curiosidade|K UW R Y UW Z IY DH AE DH IH0
curioso|K UW R Y OW0 Z UW
curo|K UW R UW
curta|K UW R T AA
curto|K UW R T UW
curtume|K UW R T UW M IH0
curupira|K UW R UW P IY R AA
curvar|K UW R V AE R
custa|K UW SH T AA
custar|K UW SH T AE R
custódia|K UW SH T AO DH Y AA
cutelo|K UW T EH L UW
cuzão|K UW Z AA W
cá|K AE
cáqui|K AE K IY
cárcere|K AE R S IH0 R IH0
câmbio|K AA B Y UW
câncer|K AA S EH R
cântaro|K AA T AA R UW
cântico|K AA T IY K UW
cã|K AA
cães|K AA Y SH
cãibra|K AA Y B R AA
cão|K AA W
cãozinho|K AA W Z IY N IY0 UW
célula|S EH L UW L AA
cérebro|S EH R IH0 V R UW
céu|S EH W
cê|S EH0
cêntimo|S T IY M UW
cíclico|S IY K L IY K UW
código|K AO DH IY HH UW
cólera|K AO L IH0 R AA
cómico|K AO M IY K UW
cómoda|K AO M UW D AA
cópia|K AO P Y AA
cópula|K AO P UW L AA
córsico|K AO R S IY K UW
cômpito|K P IY T UW
cônscio|K SH S Y UW
côvão|K OW0 V AA W
cúmplice|K P L IY S IH0
cúpula|K UW P UW L AA
cúrcuma|K UW R K UW M AA
dacito|D AA S IY T UW
dai|D AE Y
dali|D AA L IY
damas|D AA M AA SH
damasco|D AA M AE SH K UW
danado|D AA N AE DH UW
danbo|D AA B UW
dando|D AA D UW
dano|D AA N UW
danoso|D AA N OW0 Z UW
dança|D AA S AA
dançarino|D AA S AA R IY N UW
danço|D AA S UW
danúbio|D AA N UW V Y UW
daquela|D AA K EH L AA
daquelas|D AA K EH L AA SH
daquele|D AA K EH0 L IH0
daqueles|D AA K EH0 L IH0 SH
daqui|D AA K IY
daquilo|D AA K IY L UW
data|D AE T AA
datar|D AA T AE R
datiloscopia|D AA K T IY L AO SH K UW P IY AA
dava|D AE V AA
davam|D AE V AA W
david|D AA V IY D IH0
daí|D AA IY
debelar|D EH0 B EH0 L AE R
debilidade|D IH0 V IH0 L IY DH AE DH IH0
debuxar|D IH0 V UW SH AE R
decerto|D IH0 S EH R T UW
decidido|D IH0 S IH0 DH IY DH UW
decidir|D IH0 S IH0 DH IY R
decidira|D IH0 S IY DH IY R AA
decidirá|D IH0 S IY DH IY R AE
decisivo|D IH0 S IY Z IY V UW
decisão|D IH0 S IY Z AA W
declarar|D IH0 K L AA R AE R
declaração|D IH0 K L AA R AA S AA W
declarou|D IH0 K L AA R OW0 W
declive|D IH0 K L IY V IH0
decompor|D IH0 K P OW0 R
decorador|D IH0 K UW R AA DH OW0 R
decorar|D IH0 K UW R AE R
decoração|D IH0 K UW R AA S AA W
decágono|D IH0 K AE G UW N UW
dedetização|D EH0 D EH0 T SH IY Z AE S AA W
dedos|D EH0 DH UW SH
deduro|D EH0 D UW R UW
deduzir|D IH0 DH UW Z IY R
def|D EH F
defeito|D IH0 F AA Y T UW
defender|D IH0 F D EH0 R
defeso|D IH0 F EH0 Z UW
deficitário|D EH0 F IY S IY T AE RRR Y UW
definitivamente|D IH0 F IY N IY T IY V AA M T IH0
definitivo|D IH0 F IH0 N IY T IY V UW
deflagração|D EH0 F L AE G R AE S AA W
deformação|D IH0 F UW R M AA S AA W
defronte|D IH0 F R T IH0
defunto|D IH0 F T UW
degradê|D EH G R AE D EH0
degraus|D IH0 HH R AA W SH
deia|D EH Y AA
deificação|D EH0 IY F IY K AA S AA W
deitado|D AA Y T AE DH UW
deitar|D AA Y T AE R
dela|D EH L AA
dele|D EH0 L IH0
delegar|D IH0 L IH0 HH AE R
delgado|D EH L HH AE DH UW
deli|D EH L IY
delicado|D IH0 L IY K AE DH UW
deliciosa|D IH0 L IY S Y AO Z AA
deliciosamente|D IH0 L IY S Y AO Z AA M T IH0
delicioso|D IH0 L IY S Y OW0 Z UW
delito|D IH0 L IY T UW
delírio|D IH0 L IY R Y UW
demasiado|D IH0 M AA Z Y AE DH UW
demissexual|D EH0 M IY S EH0 K S UW AE L
democracia|D IH0 M UW K R AA S IY AA
demográfico|D IH0 M UW HH R AE F IY K UW
demonstrar|D IH0 M SH T R AE R
demora|D IH0 M AO R AA
demorar|D IH0 M UW R AE R
dendê|D D EH0
denso|D S UW
dentista|D T IY SH T AA
dentre|D T R IH0
dentro|D T R UW
dentário|D T AE R Y UW
dentífrico|D T IY F R IY K UW
depender|D IH0 P D EH0 R
dependência|D IH0 P D S Y AA
depois|D IH0 P OW0 Y SH
deprecar|D EH0 P R EH0 K AE R
depreciativo|D EH0 P R EH0 S Y AE T SH IY V UW
depressa|D IH0 P R EH S AA
deprê|D EH0 P R EH0
deputado|D IH0 P UW T AE DH UW
deque|D EH K IY
dera|D EH R AA
deram|D EH R AA W
derradeiro|D IH0 RH AA DH AA Y R UW
derramamento|D IH0 RH AA M AA M T UW
derramar|D IH0 RH AA M AE R
derrete|D EH0 RH EH T SH IY
derrocar|D IH0 RH UW K AE R
desafiar|D IH0 Z AA F Y AE R
desaforamento|D ZH IY Z AE F OW0 R AE M T UW
desaforar|D ZH IY Z AE F OW0 R AE R
desaforo|D ZH IY Z AE F AO R UW
desaparecer|D IH0 Z AA P AA R IH0 S EH0 R
desaparecido|D IH0 Z AA P AA R IH0 S IY DH UW
desaparecimento|D IH0 Z AA P AA R IH0 S IY M T UW
desapercebido|D ZH IY Z AE P EH0 R S EH0 B IY D UW
desarmamentista|D ZH IY Z AE R M AE M T SH IY S T AE
desarrazoar|D IH0 Z AA RH AA Z W AE R
desasar|D IH0 Z AE Z AE R
desastre|D IH0 Z AE SH T R IH0
desatar|D IH0 Z AA T AE R
desatarraxar|D IH0 Z AA T AA RH AA SH AE R
desbocado|D EH0 Z B OW0 K AE D UW
descalçar|D IH0 SH K AE L S AE R
descansar|D IH0 SH K AA S AE R
descarregar|D IH0 SH K AA RH IH0 HH AE R
descendo|D IH0 SH S D UW
descer|D IH0 SH S EH0 R
desceu|D IH0 SH S EH0 W
descia|D IH0 SH S IY AA
descida|D IH0 SH S IY DH AA
descido|D IH0 SH S IY DH UW
descoberta|D IH0 SH K UW V EH R T AA
descoberto|D IH0 SH K UW V EH R T UW
descobridor|D IH0 SH K UW V R IY DH OW0 R
descobrimento|D IH0 SH K UW V R IY M T UW
descobrir|D IH0 SH K UW V R IY R
desconexo|D ZH IY Y SH K OW0 N EH K S UW
desconfiado|D IH0 SH K F Y AE DH UW
desconhecer|D IH0 SH K UW N IY0 IH0 S EH0 R
desconhecido|D IH0 SH K UW N IY0 IH0 S IY DH UW
desconhecimento|D IH0 SH K UW N IY0 IH0 S IY M T UW
desconsideração|D IH0 SH K S IY DH IH0 R AA S AA W
desconsolado|D IH0 SH K S UW L AE DH UW
descrição|D IH0 SH K R IY S AA W
desculpa|D IH0 SH K UW L P AA
desdenhar|D IH0 ZH DH AA N IY0 AE R
desdenhoso|D IH0 ZH DH AA N IY0 OW0 Z UW
desdo|D EH0 ZH DH UW
desdém|D IH0 ZH DH AA Y
deseducado|D ZH IY Z EH0 D UW K AE D UW
desejar|D IH0 Z IH0 ZH AE R
desejo|D IH0 Z AA Y ZH UW
desejoso|D IH0 Z IH0 ZH OW0 Z UW
desencadear|D IH0 Z K AA DH Y AE R
desenhar|D IH0 Z IH0 N IY0 AE R
desenho|D IH0 Z AA N IY0 UW
desentendimento|D EH0 Z T D ZH IY M T UW
desenvencilhar|D EH0 S V S IY L IY AE R
desenvincilhar|D EH0 S V S IY L IY AE R
desenvolver|D IH0 Z V OW0 L V EH0 R
desenvolvimento|D IH0 Z V OW0 L V IY M T UW
desequilibrou|D EH0 Z EH0 K IY L IY B R OW0 W
desertificar|D IH0 Z IH0 R T IY F IY K AE R
deserto|D IH0 Z EH R T UW
desfazer|D IH0 SH F AA Z EH0 R
desfazimento|D ZH IY S F AE Z IY M T UW
desfecho|D IH0 SH F AA Y SH UW
desgostar|D IH0 ZH HH UW SH T AE R
desgosto|D IH0 ZH HH OW0 SH T UW
desgraça|D IH0 ZH HH R AE S AA
desgraçado|D IH0 ZH HH R AA S AE DH UW
desidratação|D IH0 Z IY D R AA T AA S AA W
designadamente|D IH0 Z IY HH N AE DH AA M T IH0
designado|D IH0 Z IY HH N AE DH UW
desilusão|D IH0 Z IY L UW Z AA W
desinteresse|D IH0 Z T IH0 R EH0 S IH0
desleixar|D IH0 ZH L AA Y SH AE RRR
desligado|D IH0 ZH L IY HH AE DH UW
desligar|D IH0 ZH L IY HH AE R
deslindar|D IH0 ZH L D AE R
desmaiar|D IH0 ZH M AE Y AE R
desmanchar|D IH0 ZH M AA SH AE R
desolado|D IH0 Z UW L AE DH UW
desolar|D EH0 Z OW0 L AE R
desolação|D EH0 Z OW0 L AE S AA W
desonerar|D IH0 Z UW N IH0 R AE R
desonra|D IH0 Z RH AA
desonroso|D IH0 Z RH OW0 Z UW
desordem|D IH0 Z AO R DH AA Y
desorganizado|D IH0 Z AO R HH AA N IY Z AE DH UW
despassarado|D IH0 SH P AA S AA R AE DH UW
despedido|D IH0 SH P IH0 DH IY DH UW
despedir|D IH0 SH P IH0 DH IY R
despeito|D IH0 SH P AA Y T UW
despender|D IH0 SH P D EH0 R
despenhadeiro|D IH0 SH P AA N IY0 AA DH AA Y R UW
despensa|D IH0 SH P S AA
desperdiçar|D IH0 SH P IH0 R D IY S AE R
desperdício|D IH0 SH P IH0 R DH IY S Y UW
despertador|D IH0 SH P IH0 R T AA DH OW0 R
despertar|D IH0 SH P IH0 R T AE R
desperto|D IH0 SH P EH R T UW
despesa|D IH0 SH P EH0 Z AA
despesas|D IH0 SH P EH0 Z AA SH
despir|D IH0 SH P IY R
desportivo|D IH0 SH P UW R T IY V UW
desqualificar|D IH0 SH K W AA L IY F IY K AE R
dessa|D EH S AA
dessas|D EH S AA SH
desta|D EH SH T AA
destacamento|D IH0 SH T AE K AA M T UW
destacar|D IH0 SH T AA K AE R
destas|D EH SH T AA SH
deste|D EH0 SH T IH0
desterrar|D IH0 SH T IH0 RH AE R
desterro|D IH0 SH T EH0 RH UW
destes|D EH0 SH T IH0 SH
destino|D IH0 SH T IY N UW
destras|D EH SH T R AA SH
destreza|D IH0 SH T R EH0 Z AA
destruidor|D IH0 SH T R UW IY DH OW0 R
destruir|D IH0 SH T R UW IY R
destrutivo|D IH0 SH T R UW T IY V UW
destruído|D IH0 SH T R UW IY DH UW
desvencilhar|D EH0 S V S IY L IY AE R
desviar|D IH0 ZH V Y AE R
desídia|D EH0 Z IY D ZH Y AE
desígnio|D EH0 Z IY G N Y UW
detalhe|D IH0 T AE L IY IH0
detalhes|D IH0 T AE L IY IH0 SH
deteriorar|D IH0 T IH0 R Y UW R AE R
deterioração|D IH0 T IH0 R Y UW R AA S AA W
determinação|D IH0 T IH0 R M IY N AA S AA W
detetar|D IH0 T EH T AE RRR
deturpação|D EH0 T UW RH P AE S AA W
deu|D EH0 W
deusa|D EH0 W Z AA
deuses|D EH0 W Z IH0 SH
devagar|D IH0 V AA HH AE R
devagarinho|D IH0 V AA HH AA R IY N IY0 UW
devassa|D IH0 V AE S AA
devasso|D IH0 V AE S UW
deve|D EH V IH0
devedor|D IH0 V IH0 DH OW0 R
dever|D IH0 V EH0 R
deveres|D IH0 V EH0 R IH0 SH
deveria|D IH0 V IH0 R IY AA
devesa|D IH0 V EH0 Z AA
devia|D IH0 V IY AA
devido|D EH0 V IY D UW
devorar|D IH0 V UW R AE R
devoção|D IH0 V UW S AA W
dezanove|D IH0 Z AA N AO V IH0
dezasseis|D IH0 Z AA S AA Y SH
dezassete|D IH0 Z AA S EH T IH0
dezoito|D IH0 Z OW0 Y T UW
deão|D Y AA W
diabete|D ZH IY AE B EH T SH IY
diabo|D Y AE V UW
diazinho|D IY AA Z IY N IY0 UW
dica|D IY K AA
dicionário|D IY S Y UW N AE R Y UW
diferente|D IY F IH0 R T IH0
diferentes|D IY F IH0 R T IH0 SH
diferença|D IY F IH0 R S AA
diferir|D IY F IH0 R IY R
dificuldade|D IY F IY K UW L DH AE DH IH0
difuso|D IY F UW Z UW
difícil|D IH0 F IY S IY L
digestão|D IY ZH IH0 SH T AA W
dignidade|D IY G N IY DH AE DH IH0
dignificar|D IY HH IH0 N IY F IY K AE R
digno|D IY G N UW
dildo|D IY L D UW
dilúvio|D IY L UW V Y UW
diminuir|D IH0 M IY N W IY R
diminuição|D IY M IY N UW IY S AA W
dinheirinho|D IY N IY0 AA Y R IY N IY0 UW
dino|D IY N UW
dinossauro|D IY N AO S AE W R UW
diospireiro|D Y AO SH P IY R AA Y R UW
diplomata|D IY P L UW M AE T AA
diplomático|D IY P L UW M AE T IY K UW
direitos|D IY R AA Y T UW SH
diretor|D IY R EH T OW0 R
dirigir|D IY R IY ZH IY R
dirigível|D IH0 R IY ZH IY V EH L
discente|D ZH IY S T SH IY
discernimento|D IY SH S IH0 R N IY M T UW
disciplina|D IY SH S IY P L IY N AA
discurso|D IH0 SH K UW R S UW
discussão|D IY SH K UW S AA W
discutir|D IY SH K UW T IY R
disgeusia|D IY S ZH EH0 W Z IY AE
disjunção|D IY ZH S AA
disponibilidade|D IY SH P UW N IY V IY L IY DH AE DH IH0
disponibilizar|D IY SH P UW N IY V IY L IY Z AE R
disponível|D IY SH P UW N IY V EH L
disposição|D IY SH P UW Z IY S AA W
disposto|D IY SH P OW0 SH T UW
disputar|D IY SH P UW T AE R
dissertação|D IY S IH0 R T AA S AA W
dissipar|D IY S IY P AE R
disso|D IY S UW
dissociável|D ZH IY S OW0 S IY AE V EH0 W
dissonância|D ZH IY S OW0 N AA S Y AE
distinguiam|D IY SH T G IY AA W
distinguir|D IY SH T G IY R
distinto|D IY SH T T UW
distinção|D IY SH T S AA W
distorção|D IH0 SH T UW R S AA W
distrair|D IY SH T R AA IY R
distração|D IH0 SH T R AE S AA W
distraído|D IY SH T R AA IY DH UW
distribuidor|D IH0 SH T R IY V W IY DH OW0 R
distribuir|D IH0 SH T R IY V W IY R
distribuição|D IH0 SH T R IY V W IY S AA W
distância|D IY SH T AA S Y AA
distúrbio|D IH0 SH T UW R V Y UW
dita|D ZH IY T AA
ditado|D IY T AE DH UW
ditador|D IY T AA DH OW0 R
ditadura|D IY T AA DH UW R AA
ditar|D IY T AE R
diurese|D ZH IY UW R EH Z IY
diurno|D Y UW R N UW
diversão|D IY V IH0 R S AA W
divertido|D IY V IH0 R T IY DH UW
divertimento|D IY V IH0 R T IY M T UW
divertir|D IY V IH0 RRR T IY RRR
dividir|D IH0 V IY DH IY R
divina|D IY V IY N AA
divindade|D IY V D AE DH IH0
divisão|D IY V IY Z AA W
divulgar|D IY V UW L HH AE R
divulgação|D IY V UW L HH AA S AA W
divãs|D IY V AA SH
diáspora|D Y AE SH P UW R AA
do|D UW
doação|D UW AA S AA W
dobra|D AO V R AA
dobradiça|D UW B RRR AA D IY S AA
dobrado|D UW B R AE D UW
dobras|D AO V R AA SH
dobro|D AO V R UW
doca|D AO K AA
doceiro|D UW S AA Y R UW
docemente|D OW0 S IH0 M T IH0
documental|D UW K UW M T AE L
documento|D UW K UW M T UW
dodecaedro|D UW DH IH0 K AA EH DH R UW
doentio|D W T IY UW
doença|D W S AA
doer|D W EH0 R
doloroso|D UW L UW R OW0 Z UW
dom|D
dominatrix|D OW0 M IY N AE T RRR IY K S
dominatrixes|D OW0 M IY N AE T RRR IY K S IY S
domingueiro|D UW M G AA Y R UW
dominó|D AO M IY N AO
doméstica|D UW M EH SH T IY K AA
donaire|D UW N AE Y R IH0
donatário|D UW N AA T AE R Y UW
donbass|D B AE S
donde|D D IH0
dono|D OW0 N UW
donos|D OW0 N UW SH
donzela|D Z EH L AA
dores|D OW0 R IH0 SH
dorido|D UW R IY DH UW
dormente|D UW R M T IH0
dormia|D UW R M IY AA
dormindo|D UW R M D UW
dormir|D UW R M IY R
dormitar|D UW R M IY T AE R
dorso|D OW0 R S UW
dossel|D UW S EH L
dossiê|D AO S Y EH0
dosso|D OW0 S UW
dou|D OW0 W
dourado|D OW0 W R AE DH UW
dourar|D OW0 W R AE R
douro|D OW0 W R UW
doutor|D OW0 W T OW0 R
doutrina|D OW0 W T R IY N AA
doutrinação|D OW0 W T R IY N AA S AA W
doutro|D OW0 W T R UW
doçaria|D UW S AA R IY AA
doçura|D UW S UW R AA
dreno|D RRR EH N UW
droga|D R AO HH AA
drogaria|D R UW HH AA R IY AA
drusa|D R UW Z AA
drácula|D R AE K UW L AA
ducto|D UW K T UW
dum|D
duma|D UW M AA
dumas|D UW M AA SH
duns|D SH
dupla|D UW P L AA
duquesa|D UW K EH0 Z AA
duradouro|D UW R AA DH OW0 W R UW
durar|D UW R AE R
durazzo|D UW R AE T S UW
durex|D UW RRR EH K S
dureza|D UW R EH0 Z AA
durio|D UW R IY UW
duro|D UW R UW
duto|D UW T UW
duunvirato|D UW V IY R AE T UW
duvidar|D UW V IY DH AE R
duvidoso|D UW V IY DH OW0 Z UW
dá|D AE
dácio|D AE S Y UW
dão|D AA W
década|D EH K AA DH AA
décimo|D EH S IY M UW
dê|D EH0
dêem|D EH0 AA Y
dígito|D IY ZH IY T UW
díptico|D IY P T IY K UW
dó|D AO
dócil|D AO S IY L
dúvida|D UW V IY D AA
dúzia|D UW Z Y AA
e|EH
ebó|EH0 B AO
eclesiástico|IY K L IH0 Z Y AE SH T IY K UW
eclipsar|IY K L IY P S AE R
eco|EH K UW
ecografia|EH K AO G R AA F Y AA
economia|EH K AO N UW M IY AA
economista|EH K UW N UW M IY SH T AA
económico|IY K UW N AO M IY K UW
ecrã|EH K R AA
eczema|EH K Z EH0 M AA
edificar|IY DH IY F IY K AE R
edificação|IY DH IY F IY K AA S AA W
edifício|IY DH IY F IY S Y UW
edito|EH0 D IY T UW
editor|IY DH IY T OW0 R
editorial|IY DH IY T UW R Y AE L
educado|IY DH UW K AE DH UW
educar|IY DH UW K AE R
egoísmo|IY HH W IY ZH M UW
egoísta|IY HH W IY SH T AA
egrégio|IY G RRR EH ZH Y UW
ela|EH L AA
elaborado|IY L AA B UW R AE D UW
elaborar|IY L AA B UW R AE R
elasticidade|IY L AA SH T IH0 S IY DH AE DH IH0
eleger|IY L IH0 ZH EH0 R
elegível|IY L IH0 ZH IY V EH L
elemento|IY L IH0 M T UW
elevado|IY L IH0 V AE DH UW
elevador|IY L IH0 V AA DH OW0 R
elevar|IY L IH0 V AE R
elevação|IY L IH0 V AA S AA W
eliminar|IY L IY M IY N AE RRR
eliminação|IY L IH0 M IY N AA S AA W
elmo|EH L M UW
elo|EH L UW
eloquência|IY L UW K W S Y AA
elucubrar|EH0 L UW K UW B RRR AE R
elucubração|EH0 L UW K UW B R AE S AA W
elástico|IY L AE SH T IY K UW
em|AA Y
emascular|IY M AA S K UW L AE R
embaixada|B AE Y SH AE DH AA
embaixador|B AE Y SH AA DH OW0 R
embarcar|B AA R K AE R
embarcação|B AA R K AA S AA W
embargo|B AE R HH UW
embolar|B OW0 L AE R
embora|B AO R AA
emboscada|B UW SH K AE D AA
emboscar|B UW SH K AE R
embrulhado|B R UW L IY AE DH UW
embrulhar|B R UW L IY AE R
embrulho|B R UW L IY UW
emburrecer|B UW RH EH0 S EH0 R
emburrecimento|B UW RH EH0 S IY M T UW
emendar|IY M D AE R
ementa|IY M T AA
emigrante|IY M IY HH R AA T IH0
emigrar|IY M IY G R AE R
emoldurar|IY M OW0 L D UW R AE R
emoção|IY M UW S AA W
empenho|P AA N IY0 UW
empertigar|EH0 M P EH0 R T IY HH AE R
empiorar|P Y UW R AE R
empolado|M P OW0 L AE D UW
empreender|P R Y D EH0 R
empregado|P R IH0 HH AE DH UW
empregar|P R IH0 HH AE R
emprego|P R EH HH UW
empréstimo|P R EH SH T IY M UW
empunhar|P UW Y AE R
empurrar|P UW RH AE R
empáfia|P AE F Y AA
emular|IY M UW L AE R
emulação|IY M UW L AA S AA W
enaltecer|IY N AE L T IH0 S EH0 R
encafifar|K AE F IY F AE R
encaixilhar|K AE Y SH IY L IY AE R
encaixotar|K AE Y SH UW T AE R
encalistrar|K AE L IY S T R AE R
encantado|K AA T AE D UW
encantar|K AA T AE R
encantação|K AA T AA S AA W
encanto|K AA T UW
encarado|K AA R AE D UW
encarar|K AA R AE R
encarnado|K AA R N AE DH UW
encavacar|K AE V AE K AE R
encenação|S IH0 N AA S AA W
encharcado|SH AA R K AE D UW
enchendo|SH D UW
encher|SH EH0 R
enchimento|SH IY M T UW
encolher|K UW L IY EH0 R
encolheu|K UW L IY EH0 W
encolhido|K UW L IY IY DH UW
encomenda|K UW M D AA
encomendar|K UW M D AE R
encontrado|K T R AE DH UW
encontrar|K T R AE R
encontro|K T R UW
encontrão|K T R AA W
encorajamento|K UW R AA ZH AA M T UW
encorajar|K UW R AA ZH AE R
encosta|K AO SH T AA
encostado|K UW SH T AE DH UW
encostar|K UW SH T AE R
endomingado|D UW M G AE DH UW
endoscopia|D OW0 SH K OW0 P IY AE
endurecer|D UW R IH0 S EH0 R
energia|IY N IH0 R ZH IY AA
enervar|IY N IH0 R V AE R
eneágono|EH N Y AE HH UW N UW
enfermaria|F IH0 R M AA R IY AA
enfermeiro|F IH0 R M AA Y R UW
enfermidade|F IH0 R M IY DH AE DH IH0
enfiar|F Y AE R
enfrentar|F R T AE R
enfurecer|F UW R IH0 S EH0 R
enganar|G AA N AE R
engano|G AA N UW
enganoso|G AA N OW0 Z UW
engarrafamento|G AA RH AA F AA M T UW
engarrafar|G AA RH AA F AE R
engavete|G AE V EH T SH IY
engenho|ZH AA N IY0 UW
engolir|G UW L IY R
engordar|G UW R DH AE R
engorgitamentos|G OW0 RH ZH IY T AE M T UW S
engorovinhado|G OW0 R OW0 V IY N IY0 AE D UW
engrandecer|G R AA D IH0 S EH0 R
engruvinhado|G R UW V IY N IY0 AE D UW
enguia|G IY AA
enguiçar|G IY S AE R
enguiço|G IY S UW
enjoar|ZH W AE R
enjoo|ZH OW0 UW
enlevo|EH0 Y L EH0 V UW
enlouquecer|L OW0 W K IH0 S EH0 R
enojar|IY N UW ZH AE R
enorme|IY N AO R M IH0
enormemente|IY N AO R M IH0 M T IH0
enquadramento|K W AA DH R AA M T UW
enquadrar|K W AA DH R AE R
enquanto|K W AA T UW
enraizar|RH AA IY Z AE R
enriquecer|RH IY K IH0 S EH0 R
ensinar|S IY N AE R
ensino|S IY N UW
ensonado|S UW N AE DH UW
ensopar|S UW P AE R
entalhe|T AE L IY IH0
enteado|T Y AE DH UW
entendimento|T D IY M T UW
enterrado|T IH0 RH AE DH UW
enterrar|T IH0 RH AE R
entra|T R AA
entrada|T R AE D AA
entrado|T R AE D UW
entrando|T R AA D UW
entrar|T R AE R
entrava|T R AE V AA
entreaberto|T R Y AA V EH R T UW
entregador|T R EH0 G AE D OW0 R
entregar|T R IH0 HH AE R
entregou|T R IH0 HH OW0 W
entremeio|T R EH0 M EH0 IY UW
entremez|T R IH0 M EH0 SH
entretenimento|T R IH0 T IH0 N IY M T UW
entrevista|T R IH0 V IY SH T AA
entrevistar|T R IH0 V IY SH T AE R
entristecer|T R IY SH T IH0 S EH0 R
entro|T R UW
entroncamento|T R K AA M T UW
entrou|T R OW0 W
entusiasmar|T UW Z Y AA ZH M AE R
entusiasmo|T UW Z Y AE ZH M UW
entusiasta|T UW Z Y AE SH T AA
entusiasticamente|T UW Z Y AE SH T IY K AA M T IH0
entusiástico|T UW Z Y AE SH T IY K UW
envelhecer|V IH0 L IY IH0 S EH0 R
envelhecimento|V IH0 L IY IH0 S IY M T UW
envelope|V IH0 L AO P IH0
envencilhar|V S IY L IY AE R
envenenamento|V IH0 N IH0 N AA M T UW
envenenar|V IH0 N IH0 N AE R
envergonhado|V IH0 R HH UW N IY0 AE DH UW
envergonhar|V IH0 R HH UW N IY0 AE R
enviar|V Y AE R
envio|V IY UW
envolver|V OW0 L V EH0 R
envólucro|V AO L UW K R UW
enzimático|Z IY M AE T IY K UW
enérgico|IY N EH R ZH IY K UW
eoceno|EH AO S EH0 N UW
eoo|EH0 AO UW
epidemia|IY P IY DH IH0 M IY AA
epigenesia|EH0 P IY ZH EH0 N EH0 Z IY AE
epigenia|EH0 P IY ZH EH0 N IY AE
episódio|IY P IY Z AO DH Y UW
equidade|EH K W IY D AE D IH0
equilibrar|IY K IY L IY B R AE R
equipamento|IY K IY P AA M T UW
equipar|IY K IY P AE R
equipe|EH K IY P IH0
equipendência|EH K W IY P D S Y AA
equitação|IY K IY T AA S AA W
equivalente|IY K IY V AA L T IH0
equivocou|EH0 K IY V OW0 K OW0 W
era|EH R AA
eram|EH R AA W
eremita|IY R IH0 M IY T AA
erguendo|IY R HH D UW
erguer|EH0 R G EH0 R
ergueu|IY R HH EH0 W
erguido|IY R HH IY DH UW
ergástulo|EH R G AE SH T UW L UW
ermida|IY R M IY DH AA
ermo|EH0 R M UW
erradicar|IY RH AA DH IY K AE R
errado|IY RH AE DH UW
errar|IY RH AE R
esboçar|IY ZH B UW S AE R
esboço|IH0 ZH B AO S UW
esbranquiçado|IY ZH B R AA K IY S AE D UW
esburacar|IY ZH B UW R AA K AE R
escabelo|IY SH K AA B EH0 L UW
escachar|IY SH K AA SH AE R
escada|IY SH K AE D AA
escadaria|IY SH K AE D AE R IY AA
escala|IY SH K AE L AA
escalar|IY SH K AA L AE R
escancarar|IY SH K AA K AA R AE R
escandinávia|IY SH K AA D IY N AE V Y AA
escanho|IY SH K AA N IY0 UW
escano|IY SH K AA N UW
escapar|IY SH K AA P AE R
escaravelho|IY SH K AA R AA V AA Y L IY UW
escarlate|IY SH K AA R L AE T IH0
escarnecer|IY SH K AA R N IH0 S EH0 R
escassez|IY SH K AA S EH0 SH
escasso|IY SH K AE S UW
escoamento|IY SH K W AA M T UW
escoar|IY SH K W AE R
escolha|IY SH K OW0 L IY AA
escolher|IY SH K UW L IY EH0 R
escolhos|IY SH K AO L IY UW SH
escolinha|IY SH K AO L IY N IY0 AA
esconder|IY SH K D EH0 R
escondido|IY SH K D IY DH UW
esconjurar|IY SH K ZH UW R AE R
esconjuro|IY SH K ZH UW R UW
escorpião|IY SH K UW R P Y AA W
escorrega|IY SH K UW RH EH HH AA
escorregar|IY SH K UW RH IH0 HH AE R
escova|IH0 SH K OW0 V AA
escovar|IH0 SH K UW V AE R
escravização|IY SH K R AA V IY Z AA S AA W
escrever|IY SH K R IH0 V EH0 R
escrita|IY SH K R IY T AA
escrito|IY SH K R IY T UW
escritor|IY SH K R IY T OW0 R
escritório|IY SH K R IY T AO R Y UW
escrivão|IY SH K R IY V AA W
escrotal|IH0 SH K R UW T AE L
escrúpulo|IY SH K R UW P UW L UW
escudo|IY SH K UW D UW
escumalha|IY SH K UW M AE L IY AE
escumalho|IY SH K UW M AE L IY UW
escura|IY SH K UW R AA
escurecer|IY SH K UW R IH0 S EH0 R
escuridão|IY SH K UW R IY DH AA W
escutar|IY SH K UW T AE R
escárnio|IY SH K AE R N Y UW
escândalo|IY SH K AA D AA L UW
esforçar|IY SH F UW R S AE R
esforço|IH0 SH F OW0 R S UW
esfregar|IH0 SH F R IH0 HH AE R
eslavo|IH0 ZH L AE V UW
esmagado|IY ZH M AA HH AE DH UW
esmagamento|IH0 ZH M AA HH AA M T UW
esmagar|IH0 ZH M AA HH AE R
esotérico|IY Z AO T EH R IY K UW
esotéricos|IY Z AO T EH R IY K UW S
espadachim|IY SH P AA DH AA SH
espalhar|IH0 SH P AA L IY AE R
espanhol|IH0 SH P AA N IY0 AO L
espantado|IY SH P AA T AE DH UW
espanto|IH0 SH P AA T UW
espantoso|IH0 SH P AA T OW0 Z UW
esparavel|IY SH P AA R AA V EH L
espaço|IY SH P AE S UW
espaçoso|IY SH P AA S OW0 Z UW
especialidade|IY SH P IH0 S Y AA L IY DH AE DH IH0
espectador|IY SH P EH K T AA D OW0 R
espectro|IH0 SH P EH K T R UW
espelho|IH0 SH P EH L IY UW
espera|IH0 SH P EH R AA
esperando|IY SH P IH0 R AA D UW
esperança|IY SH P IH0 R AA S AA
esperar|SH P IH0 R AE R
esperava|IY SH P IH0 R AE V AA
esperma|IH0 SH P EH R M AA
esperto|IH0 SH P EH R T UW
espesso|IY SH P EH0 S UW
espessura|IY SH P IH0 S UW R AA
espetacular|IY SH P EH T AA K UW L AE R
espetador|IY SH P EH T AA D OW0 R
espeto|IY SH P EH T UW
espetou|IY S P EH0 T OW0 W
espetáculo|IY SH P EH T AE K UW L UW
espiga|IY SH P IY HH AA
espinela|IH0 SH P IY N EH L AA
espinha|IH0 SH P IY N IY0 AA
espinho|SH P IY N IY0 UW
espiritual|IY SH P IY R IY T W AE L
espirrar|IY SH P IY RH AE R
espirro|IY SH P IY RH UW
esplendor|IY SH P L D OW0 R
esplêndido|IY SH P L D IY DH UW
esponja|IH0 SH P ZH AA
esponsal|IY SH P S AE L
espora|IH0 SH P AO R AA
espreitar|IY SH P R AA Y T AE R
espécie|IH0 SH P EH S Y IH0
esquecido|IY SH K IH0 S IY DH UW
esqueleto|IH0 SH K IH0 L EH0 T UW
esquerdino|IY SH K IH0 R DH IY N UW
esqui|IH0 SH K IY
esquina|IH0 SH K IY N AA
esquisito|IY SH K IH0 Z IY T UW
esquizofrénico|IY SH K IY Z AO F R EH N IY K UW
essa|EH S AA
essência|IY S S Y AA
estaca|IY SH T AE K AA
estacionamento|IY SH T AA S Y UW N AA M T UW
estacionar|IY SH T AA S Y UW N AE R
estado|IY SH T AE DH UW
estalagem|IY SH T AA L AE ZH AA Y
estalar|IY SH T AA L AE R
estandarte|IY SH T AA D AE R T IH0
estando|IY SH T AA D UW
estante|IY SH T AA T IH0
estatura|IY SH T AE T UW R AA
estatuto|IH0 SH T AA T UW T UW
esteio|IY SH T AA Y UW
esteira|IY SH T AA Y R AA
estendendo|IY SH T D D UW
estender|IY SH T D EH0 R
estendeu|IY SH T D EH0 W
esterno|IY SH T EH R N UW
esticado|IY SH T IY K AE DH UW
esticar|IY SH T IY K AE R
estilete|IY SH T IY L EH0 T IY
estilo|IH0 SH T IY L UW
estima|IY SH T IY M AA
estimulador|IH0 SH T IY M UW L AA DH OW0 R
estimulante|IH0 SH T IY M UW L AA T IH0
estivar|IY SH T IY V AE R
estofado|EH0 S T OW0 F AE D UW
estola|IY SH T AO L AA
estoma|IH0 SH T OW0 M AA
estontear|IY SH T T Y AE R
estopim|IY S T UW P
estore|IY SH T AO R IH0
estourar|IY SH T OW0 W R AE R
estrada|IY SH T R AE DH AA
estragar|IY SH T R AA HH AE R
estrangeiro|IY SH T R AA ZH AA Y R UW
estranha|SH T R AA N IY0 AA
estranhar|IY SH T R AA N IY0 AE R
estranhas|SH T R AA N IY0 AA SH
estranho|IY SH T R AA N IY0 UW
estranhos|SH T R AA N IY0 UW SH
estratagema|IH0 SH T R AA T AA ZH EH0 M AA
estrear|IY SH T R Y AE R
estreia|IY SH T R AA Y AA
estreitar|IY SH T R AA Y T AE R
estreitas|IY SH T R AA Y T AA SH
estrela|IH0 SH T R EH0 L AA
estrelas|IH0 SH T R EH0 L AA SH
estribilho|IY SH T R IY V IY L IY UW
estrondo|IH0 SH T R D UW
estropear|IY SH T R UW P Y AE R
estrume|IH0 SH T R UW M IH0
estrumpfe|IH0 SH T R F IH0
estrutura|SH T R UW T UW R AA
estudar|IY SH T UW DH AE R
estudioso|IY SH T UW DH Y OW0 Z UW
estudo|IH0 SH T UW DH UW
estupidamente|IY SH T UW P IY DH AA M T IH0
estupro|IY S T UW P R UW
estátua|IY SH T AE T W AA
estável|IY SH T AE V EH L
estância|IH0 SH T AA S Y AA
estética|IH0 SH T EH T IY K AA
estético|IY SH T EH T IY K UW
estéticos|IY SH T EH T IY K UW SH
estêvão|IY SH T EH0 V AA W
estômago|IH0 SH T OW0 M AA HH UW
estúpido|IY SH T UW P IY D UW
esvaziar|IY ZH V AA Z Y AE R
etapa|IY T AE P AA
eternamente|IY T EH R N AA M T IH0
eternidade|IY T IH0 R N IY DH AE DH IH0
eterno|IY T EH R N UW
etna|EH T N AA
etnolinguística|EH T N AO L G W IY SH T IY K AA
etnolinguístico|EH T N AO L G W IY SH T IY K UW
etólogo|EH0 T AO L OW0 G UW
eu|EH0 W
euro|EH0 W R AO
europa|EH0 W R AO P AA
europeia|EH0 W R UW P AA Y AA
eurovisivo|EH0 W R UW V IY Z IY V UW
evaporar|IY V AA P UW R AE R
evaporação|IY V AA P UW R AA S AA W
evento|IY V T UW
eventual|IY V T W AE L
evidente|IY V IY DH T IH0
evocar|IY V UW K AE RRR
fabricante|F AE V R IY K AA T IH0
fabricar|F AA V R IY K AE R
fabricação|F AA V R IY K AA S AA W
faca|F AE K AA
fachada|F AA SH AE DH AA
facho|F AE SH UW
facilmente|F AE S IY L M T IH0
facto|F AE K T UW
factível|F AA K T IY V EH L
facão|F AE K AA W
fadiga|F AA DH IY HH AA
fadigar|F AA DH IY HH AE R
fado|F AE DH UW
faia|F AE Y AA
faiança|F AA Y AA S AA
faixa|F AE Y SH AA
fala|F AE L AA
falam|F AE L AA W
falena|F AA L EH0 N AA
falha|F AE L IY AA
falo|F AE L UW
faminto|F AA M T UW
famílias|F AA M IY L Y AA SH
faq|F AE K
farejar|F AA R IH0 ZH AE R
farmácia|F AA R M AE S Y AA
faro|F AE R UW
farsa|F AE RRR S AA
farto|F AE R T UW
fartura|F AE RH T UW R AE
fastidioso|F AA SH T IY D Y OW0 Z UW
fatalidade|F AA T AA L IY DH AE DH IH0
fatalismo|F AA T AA L IY ZH M UW
fatia|F AA T IY AA
fatiota|F AE T SH IY AO T AA
fato|F AE T UW
fatura|F AE T UW R AA
fatwa|F AE T W AA
fauno|F AE W N UW
fava|F AE V AA
favoravelmente|F AA V UW R AE V EH L M T IH0
favorecer|F AA V UW R IH0 S EH0 R
favorecido|F AA V UW R IH0 S IY DH UW
favorito|F AA V UW RRR IY T UW
fazenda|F AA Z D AA
faça|F AE S AA
façam|F AE S AA W
faço|F AE S UW
febre|F EH V R IH0
fechada|F IH0 SH AE DH AA
fechadas|F IH0 SH AE DH AA SH
fechado|F IH0 SH AE DH UW
fechados|F IH0 SH AE DH UW SH
fechadura|F IH0 SH AA DH UW R AA
fedelho|F IH0 DH AA L IY UW
feder|F IH0 DH EH0 R
federação|F IH0 DH IH0 R AA S AA W
fedor|F IH0 DH OW0 R
fedorento|F IH0 DH UW R T UW
feedback|F IY D IH0 B EH K IH0
feioso|F EH0 Y OW0 Z UW
feitio|F AA Y T IY UW
feitiço|F AA Y T IY S UW
felicidade|F IH0 L IY S IY DH AE DH IH0
felino|F IH0 L IY N UW
femicídio|F EH0 M IY S IY D ZH Y UW
feminicídio|F EH0 M IY N IY S IY D ZH Y UW
feminilidade|F IH0 M IH0 N IY L IY DH AE DH IH0
feminismo|F IH0 M IH0 N IY ZH M UW
fenestra|F IH0 N EH SH T R AA
fera|F EH R AA
ferida|F IH0 R IY D AA
ferido|F IH0 R IY DH UW
ferir|F IH0 R IY R
fernandes|F IH0 R N AA D IH0 SH
ferradura|F IH0 RH AA DH UW R AA
ferramenta|F EH RH AA M T AA
ferrenho|F IH0 RH AA N IY0 UW
ferros|F EH RH UW SH
ferrugem|F IH0 RH UW ZH Y
fertilizante|F IH0 R T IH0 L IY Z AA T IH0
ferver|F IH0 R V EH0 R
fervor|F IH0 R V OW0 R
festa|F EH SH T AA
feto|F EH T UW
feudalismo|F EH0 W D AE L IY SH M UW
feudo|F EH0 W D UW
fi|F IY
fiambre|F Y AA B R IH0
fiasco|F Y AE SH K UW
fica|F IY K AA
ficado|F IY K AE DH UW
ficando|F IY K AA D UW
ficar|F IY K AE R
ficara|F IY K AE R AA
ficaram|F IY K AE R AA W
ficará|F IY K AA R AE
ficava|F IY K AE V AA
ficha|F IY SH AA
fico|F IY K UW
ficou|F IY K OW0 W
fictício|F IY K T IY S Y UW
ficção|F IY K S AA W
fidalgos|F IY DH AE L HH UW SH
fidúcia|F IY D UW S Y AE
figo|F IY G UW
figueira|F IY G AA Y R AA
figueiredo|F IY G AA Y R EH0 D UW
figura|F IY HH UW R AA
fiji|F IY ZH IY
fila|F IY L AA
filantrópica|F IY L AA T R AO P IY K AA
filantrópico|F IY L AA T R AO P IY K UW
filha|F IY L IY AA
filho|F IY L IY UW
filhota|F IY L IY AO T AA
filhó|F IY L IY AO
filigrana|F IY L IY HH R AA N AA
filipa|F IY L IY P AA
filme|F IY L M IH0
filo|F IY L UW
filosofia|F IY L UW Z UW F IY AA
filáucia|F IY L AE W S Y AA
filão|F IY L AA W
filé|F IY L EH
filósofo|F IY L AO Z UW F UW
filósofos|F IY L AO Z UW F UW SH
fim|F
finai|F IY N AE Y
finalizar|F IY N AA L IY Z AE R
finalização|F IY N AA L IY Z AA S AA W
financiar|F IY N AA S Y AE R
finando|F IY N AA D UW
finara|F IY N AE R AA
finaram|F IY N AE R AA W
finava|F IY N AE V AA
finavam|F IY N AE V AA W
findar|F D AE R
findo|F D UW
finesa|F IY N EH0 Z AA
fineza|F IY N EH0 Z AA
fingimento|F ZH IY M T UW
fingir|F ZH IY R
finita|F IY N IY T AA
finito|F IY N IY T UW
finlandesa|F L AA D EH0 Z AA
finou|F IY N OW0 W
fins|F SH
finta|F T AA
fio|F IY UW
fiquei|F IY K AA Y
firme|F IY R M IH0
firula|F IY R UW L AE
fisgada|F IY ZH HH AE DH AA
fisionomia|F IY Z Y UW N UW M IY AA
fisiopatológico|F IY Z Y AO P AA T UW L AO ZH IY K UW
fissurar|F IY S UW R AE R
fita|F IY T AA
fivela|F IY V EH L AA
fixar|F IY K S AE R
fixe|F IY K S IH0
fixo|F IY K S UW
fizera|F IY Z EH R AA
fizeram|F IY Z EH R AA W
flaca|F L AE K AA
flaco|F L AE K UW
flagelo|F L AA ZH EH0 L UW
flamengo|F L AA M G UW
flamingo|F L AA M G UW
flamífero|F L AE M IY F EH0 R UW
flamígero|F L AE M IY ZH EH0 R UW
flanco|F L AA K UW
flanela|F L AA N EH L AA
flauta|F L AE W T AA
flecha|F L EH SH AA
flora|F L AO R AA
flores|F L OW0 R IH0 SH
floresta|F L UW R EH SH T AA
florete|F L UW R EH0 T IH0
florim|F L UW RRR
florir|F L UW R IY R
florista|F L UW R IY SH T AA
flume|F L UW M IH0
fluxo|F L UW K S UW
fluência|F L UW S Y AE
flúmen|F L UW M Y
flúor|F L UW AO R
fobia|F UW V IY AA
foca|F AO K AA
foco|F AO K UW
fodo|F OW0 DH UW
fodão|F AO D AA W
fodões|F AO D Y SH
fofo|F OW0 F UW
fofoca|F AO F AO K AE
fofura|F OW0 F UW R AE
fogaréu|F UW HH AA R EH W
fogaça|F OW0 G AE S AE
fogueira|F UW HH AA Y R AA
foguete|F UW HH EH0 T IH0
fogão|F UW HH AA W
foi|F OW0 Y
folha|F AO L IY AA
folhas|F OW0 L IY AA SH
folhear|F UW L IY Y AE R
folho|F OW0 L IY UW
folhos|F AO L IY UW S
folia|F UW L IY AA
fona|F OW0 N AA
fonema|F UW N EH M AA
fora|F AO R AA
foram|F OW0 R AA W
forasteiro|F UW R AA SH T AA Y R UW
forja|F AO R ZH AA
formado|F UW R M AE DH UW
formador|F UW R M AA DH OW0 R
formais|F AO R M AE Y SH
formar|F UW R M AE R
formação|F UW R M AA S AA W
formiga|F UW R M IY HH AA
formigar|F UW R M IY G AE R
formigueiro|F UW R M IY HH AA Y R UW
formosa|F UW R M AO Z AA
formoso|F UW R M OW0 Z UW
fornalha|F UW R N AE L IY AA
fornecimento|F UW R N IH0 S IY M T UW
forno|F OW0 R N UW
foro|F AO R UW
forrado|F UW RH AE DH UW
forrar|F UW RH AE R
forró|F AO RH AO
forte|F AO R T IH0
fortemente|F AO R T IH0 M T IH0
fortes|F AO R T IH0 SH
fortificação|F AO R T IY F IY K AA S AA W
fortuna|F UW R T UW N AA
força|F OW0 R S AA
forçado|F UW R S AE DH UW
forçar|F UW R S AE R
forças|F OW0 R S AA SH
foto|F AO T AO
fouce|F OW0 W S IH0
fraca|F R AE K AA
fraco|F R AE K UW
fragata|F R AA HH AE T AA
fragilidade|F R AA ZH IH0 L IY DH AE DH IH0
fragrância|F R AA HH R AA S Y AA
francesa|F R AA S EH0 Z AA
franco|F R AA K UW
franga|F R AA G AA
frango|F R AA G UW
frança|F R AA S AA
frapê|F R AE P EH0
fraquejar|F R AA K IH0 ZH AE R
fraqueza|F R AA K EH0 Z AA
frasco|F R AE SH K UW
frase|F R AE Z IH0
fraseado|F R AA Z Y AE D UW
frases|F R AE Z IH0 SH
fraternidade|F R AA T IH0 R N IY DH AE DH
fraterno|F R AA T EH R N UW
fração|F R AE S AA W
freira|F R AA Y R AA
fremente|F R EH0 M T SH IY
fresco|F R EH0 SH K UW
frescura|F R IH0 SH K UW R AA
fresta|F R EH SH T AA
fria|F R IY AA
friagem|F R IY AE ZH Y
frialdade|F R IY AE L DH AE DH IH0
frincha|F R SH AA
friorento|F R IY UW R T UW
frisa|F R IY Z AA
friso|F R IY Z UW
froco|F RRR AO K UW
froixo|F R OW0 Y SH UW
fronte|F R T IH0
fronteira|F R T AA Y R AA
frouxidão|F R OW0 W SH IY D AA W
frouxo|F R OW0 W SH UW
frufru|F R UW F R UW
fruiteira|F R UW Y T AA Y R AA
fruição|F R UW Y S AA W
fruta|F R UW T AA
fruteira|F R UW T AA Y R AA
fruto|F R UW T UW
frágil|F R AE ZH IY L
frângão|F R AA HH AA W
fueguino|F W IH0 HH IY N UW
fuga|F UW G AA
fugido|F UW ZH IY DH UW
fugindo|F UW ZH D UW
fugir|F UW ZH IY R
fugitivo|F UW ZH IY T IY V UW
fugiu|F UW ZH IY W
fui|F UW Y
fulano|F UW L AA N UW
fulgurar|F UW L G UW R AE R
fulá|F UW L AE
fumando|F UW M AA D UW
fumar|F UW M AE R
fumo|F UW M UW
fumoso|F UW M OW0 Z UW
fumígeno|F UW M IY ZH EH0 N UW
funcho|F SH UW
funcionar|F S Y UW N AE R
funcionário|F S Y UW N AE R Y UW
funda|F D AA
fundamento|F D AA M T UW
fundar|F D AE R
fundação|F D AA S AA W
fundir|F D IY R
fundição|F D IY S AA W
fundo|F D UW
fundão|F D AA W
fungar|F G AE R
fungo|F G UW
fungou|F G OW0 W
função|F S AA W
furibundo|F UW R IY B D UW
furiosamente|F UW R Y AO Z AA M T IH0
furioso|F UW R Y OW0 Z UW
furo|F UW R UW
furão|F UW R AA W
fusa|F UW Z AA
fustigar|F UW SH T IY HH AE R
fusão|F UW Z AA W
futicar|F UW T SH IY K AE RH
futrica|F UW T R IY K AE
futricada|F UW T R IY K AE D AE
futricagem|F UW T R IY K AE ZH AA Y
futricar|F UW T R IY K AE RH
futriqueiro|F UW T R IY K EH0 Y R UW
futucar|F UW T UW K AE RH
futuro|F UW T UW R UW
fuxicar|F UW SH IY K AE R
fuxico|F UW SH IY K UW
fá|F AE
fábrica|F AE V R IY K AA
fábula|F AE B UW L AA
fácil|F AE S IY L
fã|F AA
fé|F EH
fécula|F EH K UW L AA
féria|F EH R Y AA
férias|F EH R Y AA SH
fíji|F IY ZH IY
física|F IY Z IY K AA
físico|F IY Z IY K UW
fólio|F AO L Y UW
fórmico|F AO R M IY K UW
fórmula|F AO R M UW L AA
fórum|F AO R
fúria|F UW R Y AA
gafanhoto|G AA F AA N IY0 OW0 T UW
gaia|G AE Y AA
gaiatar|G AE Y AE T AE R
gaiatice|G AE Y AE T SH IY S IY
gaiato|G AE Y AE T UW
gaio|G AE Y UW
gaita|G AE Y T AA
gaitar|G AE Y T AE R
gaivota|G AE Y V AO T AA
gajeiro|G AE ZH AA Y R UW
gajo|G AE ZH UW
gala|G AE L AA
galardão|G AA L AA R DH AA W
galeria|G AA L IH0 R IY AA
galho|G AE L IY UW
galilé|G AA L IY L EH
galinha|G AA L IY N IY0 AA
galinheiro|G AA L IY N IY0 AA Y R UW
galo|G AE L UW
galopeado|G AE L OW0 P IY AE D UW
galáxia|G AA L AE K S Y AA
galé|G AA L EH
gamar|G AA M AE R
gamba|G AA B AA
gambá|G AA B AE
gamer|G AA Y M AA R
gancho|G AA SH UW
ganga|G AA G AA
ganho|G AA N IY0 UW
ganhão|G AA N IY0 AA W
gansa|G AA S AA
ganso|G AA S UW
ganza|G AA Z AA
garantir|G AA R AA T IY R
garfo|G AE R F UW
garganta|G AA R HH AA T AA
gari|G AE R IY
garoto|G AA R OW0 T UW
garrancho|G AE RRR AA SH UW
garrido|G AA RH IY D UW
garrir|G AA RH IY R
garça|G AE R S AA
gasolina|G AA Z UW L IY N AA
gata|G AE T AA
gatilho|G AE T IY L IY W
gato|G AE T UW
gaveta|G AA V EH0 T AA
gavião|G AA V IY AA W
gaza|G AE Z AA
gaúcho|G AA UW SH UW
geado|ZH Y AE DH UW
geladaria|ZH IH0 L AA DH AA R IY AA
gelar|ZH IH0 L AE R
gelo|ZH EH L UW
gelosia|ZH IH0 L UW Z IY AA
gemer|ZH IH0 M EH0 R
gemido|ZH IH0 M IY DH UW
generalidade|ZH IH0 N IH0 R AA L IY DH AE DH IH0
generosidade|ZH IH0 N IH0 R UW Z IY DH AE DH IH0
generoso|ZH IH0 N IH0 R OW0 Z UW
gengiva|ZH ZH IY V AA
genioso|ZH EH0 N IY OW0 Z UW
gentílico|ZH T SH IY L IY K UW
geoclimático|ZH EH AO K L IY M AE T IY K UW
geocêntrico|ZH EH0 OW0 S T R IY K UW
gerador|ZH IH0 R AA DH OW0 R
gerar|ZH IH0 R AE R
geração|ZH IH0 R AA S AA W
geringonça|ZH IH0 R G S AA
gerontocracia|ZH IH0 R UW N T UW K R AA S IY AA
gerânio|ZH IH0 R AA N Y UW
gesso|ZH EH0 S UW
gesto|ZH EH SH T UW
gestão|ZH IH0 SH T AA W
gibi|ZH IY B IY
gibraltar|ZH IY V R AE L T AE R
gibão|ZH IY V AA W
giga|ZH IY HH AA
gigó|ZH IY G AO
gilete|ZH IY L EH T SH IY
gim|ZH
gineta|ZH IY N EH0 T AA
ginga|ZH G AA
ginásio|ZH IY N AE Z Y UW
ginástica|ZH IY N AE SH T IY K AA
giovana|ZH IY OW0 V AA N AE
gipsita|ZH IY P S IY T AA
girafa|ZH IY R AE F AA
girassol|ZH IY R AA S AO L
girassóis|ZH IY R AA S AO Y SH
giro|ZH IY R UW
giz|ZH IY SH
glande|G L AA D IH0
glauca|G L AE W K AA
glauco|G L AE W K UW
gleba|G L EH B AE
glicina|G L IY S IY N AA
glifo|G L IY F UW
glorificação|G L OW0 R IY F IY K AE S AA W
glosar|G L UW Z AE R
glossário|G L UW S AE R Y UW
gluão|G L UW AA W
gládio|G L AE DH Y UW
glândula|G L AA D UW L AA
glúten|G L UW T EH N
gnomo|G N OW0 M UW
goa|G OW0 AA
godo|G OW0 D UW
goi|G AO Y
goivo|G OW0 Y V UW
gola|G AO L AA
goleador|G UW L Y AA D OW0 R
golfinho|G OW0 L F IY N IY0 UW
golo|G OW0 L UW
golpe|G AO L P IH0
gomes|G OW0 M IH0 SH
gonzo|G Z UW
google|G UW G OW0 L
gorda|G OW0 R DH AA
gordo|G OW0 R DH UW
gordura|G UW R DH UW R AA
gorila|G UW R IY L AA
gorjeio|G UW RRR ZH AA Y UW
gorovinha|G OW0 R AO V IY N IY0 AE
gota|G AO T AA
goteira|G OW0 T EH0 Y R AE
governador|G UW V IH0 R N AA DH OW0 R
governar|G UW V IH0 R N AE R
governo|G UW V EH0 R N UW
gozando|G UW Z AA D UW
gozo|G AO Z UW
gracejar|G R AA S IH0 ZH AE R
gracioso|G R AA S Y OW0 Z UW
grade|G R AE DH IH0
grado|G R AE DH UW
graduação|G R AA DH W AA S AA W
grafiteiro|G R AA F IY T AA Y R UW
grafo|G R AE F UW
grafíti|G R AE F IY T IY
gralha|G R AE L IY AA
gramatical|G RRR AE M AE T SH IY K AE W
grampo|G R AA P UW
grana|G RRR AA N AA
granada|G R AA N AE DH AA
grandão|G R AA D AA W
granito|G R AA N IY T UW
granja|G R AA ZH AA
gratinar|G R AA T IY N AE R
grau|G R AE W
grava|G R AE V AA
gravata|G R AA V AE T AA
gravidade|G R AA V IY DH AE DH IH0
gravitão|G RRR AA V IY T AA W
gravura|G R AA V UW R AA
graxa|G R AE SH AA
graxo|G R AE SH UW
graça|G R AE S AA
graças|G R AE S AA SH
grego|G R EH0 HH UW
grei|G RRR EH Y
grelo|G R EH0 L UW
grenha|G R EH0 N IY0 AA
grife|G R IY F IY
grifo|G R IY F UW
grilo|G R IY L UW
grisalho|G R IY Z AE L IY UW
griso|G R IY Z UW
grisu|G R IY Z UW
gritando|G R IY T AA D UW
grito|G R IY T UW
gritos|G R IY T UW SH
gritou|G R IY T OW0 W
gritão|G R IY T AA W
groselha|G R AO Z AA Y L IY AA
grosseiro|G R UW S AA Y R UW
grosso|G R OW0 S UW
grou|G R OW0 W
grua|G R UW AA
grupo|G R UW P UW
gruta|G R UW T AA
gráfica|G R AE F IY K AA
gráfico|G R AE F IY K UW
grândola|G R AA D UW L AA
grã|G R AA
grão|G R AA W
grémio|G R EH M Y UW
guai|G W AE Y
guapo|G W AE P UW
guardado|G W AA R DH AE DH UW
guardanapo|G W AA R DH AA N AE P UW
guardar|G W AA R DH AE R
guarida|G W AE R IY D AE
guarita|G W AE R IY T AE
guarnecer|G W AA R N IH0 S EH0 R
guarujá|G W AE R UW ZH AE
guarulhense|G W AE R UW L IY S IY
guarulhos|G W AE R UW L IY UW S
gude|G UW D ZH IY
guia|G IY AA
guindar|G IY N D AE RRR
guiné|G IY N EH
guinéu|G IY N EH W
guisa|G IY Z AA
guita|G IY T AA
guitarra|G IY T AE RH AA
guizo|G IY Z UW
guião|G Y AA W
gulodice|G UW L OW0 D ZH IY S IY
gulosice|G UW L OW0 Z IY S IY
gunda|G D AA
guri|G UW R IY
guru|G UW R UW
guê|G EH0
gástrico|G AE SH T R IY K UW
géis|ZH EH Y SH
gê|ZH EH0
góes|G AO Y SH
gói|G AO Y
góis|G AO Y SH
gôndola|G D UW L AA
habilidade|AE B IY L IY DH AE DH IH0
habitante|AA B IY T AA T IH0
habitar|AA V IY T AE R
habitação|AA V IY T AA S AA W
haia|AE Y AA
haja|AE ZH AA
hamburger|AA B UW RRR G EH0 RRR
hangul|AA G UW L
harmonia|AA R M UW N IY AA
harmonioso|AA R M UW N Y OW0 Z UW
harmonizar|AA R M UW N IY Z AE R
harpa|AE R P AA
hasta|AE SH T AA
haste|AE SH T IH0
hata|AE T AA
havai|AE V AE Y
havendo|AA V D UW
haveria|AA V IH0 R IY AA
haverá|AA V IH0 R AE
havia|AA V IY AA
hebreia|IY V R AA Y AA
hebreu|IY V R EH0 W
hein|Y
heleno|IY L EH N UW
heliocêntrico|EH L Y OW0 S T R IY K UW
heliográfica|EH L Y AO G R AE F IY K AA
henrique|RH IY K IH0
henriques|RH IY K IH0 SH
heptágono|EH P T AE HH UW N UW
hera|EH R AA
herança|IY R AA S AA
herdar|EH0 R DH AE R
herdeiro|IY R DH AA Y R UW
heráldico|EH R AE L D IY K UW
hexágono|EH Z AE HH UW N UW
hibernal|IY V IH0 R N AE L
hibernar|IY V IH0 R N AE R
hidrelétrico|IY D R EH0 L EH T R IY K UW
hidrografia|IY D R OW0 G R AE F IY AE
hidrogénio|IY D R AO ZH EH N IY UW
higia|IY ZH IY AA
higiene|IY ZH Y EH N IH0
higienização|IY ZH IY EH0 N IY Z AE S AA W
hindu|D UW
hino|IY N UW
hipogrifo|IY P AO HH R IY F UW
hipopótamo|IY P AO P AO T AA M UW
hipódromo|IY P AO DH R UW M UW
hirto|IY R T UW
hisako|IY Z AE K UW
historicamente|IY SH T AO R IY K AA M T IH0
história|IY SH T AO R Y AA
histórias|IY SH T AO R Y AA SH
histórico|IY SH T AO R IY K UW
hodiernamente|OW0 D ZH IY EH0 R N AE M T SH IY
holandês|AO L AA D EH0 SH
holofote|AO L AO F AO T IH0
homenagem|AO M IH0 N AE ZH Y
homens|AO M AA Y SH
homenzinho|AO M AA Y Z IY N IY0 UW
homenzão|AO M AA Y Z AA W
homologação|OW0 M OW0 L OW0 G AE S AA W
honestidade|UW N EH SH T IY DH AE DH IH0
honesto|AO N EH SH T UW
honroso|RH OW0 Z UW
hora|AO R AA
horinha|AO R IY N IY0 AA
horrível|AO RH IY V EH L
horta|AO R T AA
hortelão|AO R T IH0 L AA W
horário|AO R AE R Y UW
hospedagem|AO SH P IH0 DH AE ZH AA Y
hospital|AO S P IY T AE W
hospitalar|AO SH P IY T AA L AE R
hospitaleiro|AO SH P IY T AA L AA Y R UW
hospitalidade|AO SH P IY T AA L IY DH AE DH IH0
hospitalizar|AO SH P IY T AA L IY Z AE R
hospício|AO SH P IY S Y UW
hoste|AO SH T IH0
hotel|AO T EH L
houvesse|OW0 W V EH S IH0
hulha|UW L IY AA
humana|UW M AE N AA
humanidade|UW M AA N IY DH AE DH IH0
humano|UW M AA N UW
humildade|UW M IY L DH AE DH IH0
humilde|UW M IY L D IH0
humilhação|UW M IY L IY AA S AA W
humo|UW M UW
humor|UW M OW0 R
hungria|G R IY AA
há|AE
hábito|AE V IY T UW
hão|AA W
hélio|EH L Y UW
hétero|EH T EH0 R UW
hóplon|AO P L
hóstia|AO SH T Y AA
húmus|UW M UW SH
hũa|AA
ia|IY AA
iam|IY AA W
iberismo|IY V IH0 R IY ZH M UW
ibéria|IY V EH R Y AA
ibérico|IY V EH R IY K UW
iceberg|AE Y S IH0 B EH R G IH0
ida|IY DH AA
ideias|IY DH AA Y AA SH
identidade|IY D T IY DH AE DH IH0
ideologia|IY DH Y UW L UW ZH IY AA
idioma|IY DH Y OW0 M AA
ido|IY DH UW
idolatrar|IY DH UW L AA T R AE R
idoso|IY DH OW0 Z UW
idílio|IY DH IY L Y UW
idóneo|IY D OW0 N Y UW
idôneo|IY D OW0 N Y UW
ignaro|IY G N AE R UW
ignóbil|IY G N AO V IY L
igreja|IY HH R AA Y ZH AA
igrejas|IY G R AA Y ZH AA SH
igualdade|IY HH W AE L D AE DH IH0
igualha|IY HH W AE L IY AA
igualzinho|IY HH W AE L Z IY N IY0 UW
ilegível|IY L IH0 ZH IY V EH L
ilha|IY L IY AA
ilhéu|IY L IY EH W
ilibado|IY L IY B AE D UW
iludir|IY L UW DH IY R
iluminar|IY L UW M IY N AE R
iluminação|IY L UW M IY N AA S AA W
ilusionista|IY L UW Z Y UW N IY SH T AA
ilustrado|IY L UW SH T R AE DH UW
ilustrar|IY L UW SH T R AE R
ilustração|IY L UW SH T R AA S AA W
ilusão|IY L UW Z AA W
imagem|IY M AE ZH AA Y
imaginar|IY M AA ZH IY N AE R
imaginação|IY M AA ZH IY N AA S AA W
imaginário|IY M AA ZH IY N AE R Y UW
imanente|IY M AE N T SH IY
imanência|IY M AE N S Y AE
imenso|IY M S UW
imigração|IY M IY HH R AA S AA W
imitar|IY M IY T AE R
impaciente|P AA S Y T IH0
impacto|P AE K T UW
impala|P AE L AA
impenetrável|P IH0 N IH0 T R AE V EH L
impera|P EH R AA
imperecibilidade|P EH0 RRR EH0 S IY B IY L IY D AE D ZH IY
imperialmente|P IH0 R Y AE L M T IH0
impertinente|P IH0 R T IY N T IH0
impessoal|M P S W AE L
impessoalidade|P EH0 S UW AE L IY D AE D ZH IY
impeça|P EH S AA
impingir|P ZH IY R
implementar|P L IH0 M T AE R
impoluto|P OW0 L UW T UW
impopular|P UW P UW L AE R
impopularidade|P UW P UW L AA R IY DH AE DH IH0
impor|P OW0 R
importar|P UW R T AE R
importância|P UW R T AA S Y AA
impossibilidade|P UW S IY V IY L IY DH AE DH IH0
impossibilitar|P UW S IY V IY L IY T AE R
impossível|P UW S IY V EH L
imposto|P OW0 SH T UW
impraticabilidade|P RRR AE T SH IY K AE B IY L IY D AE D ZH IY
impraticável|P RRR AE T SH IY K AE V EH0 W
imprensa|P R S AA
imprescritível|P R EH0 S K RRR IY T SH IY V EH0 W
impressa|P R EH S AA
impressionado|P R IH0 S Y UW N AE DH UW
impressionar|P R IH0 S Y UW N AE R
impressora|P R IH0 S OW0 R AA
impressão|P R IH0 S AA W
imprevisto|P R IH0 V IY SH T UW
imprimir|P R IY M IY R
improvável|P R UW V AE V EH L
impulsionar|P UW L S Y UW N AE R
impulsivamente|P UW L S IY V AA M T IH0
impuro|P UW R UW
imundo|IY M D UW
imã|IY M AA
imóvel|IY M AO V EH L
inacabado|IY N AA K AA V AE DH UW
inacabável|IY N AE K AE B AE V EH0 W
incapacidade|K AA P AE S IY DH AE DH IH0
incapacitar|K AA P AE S IY T AE R
incapaz|K AA P AE SH
incauto|K AE W T UW
incendiar|S D Y AE R
incendiário|S D Y AE R Y UW
incensar|S S AE R
incenso|S S UW
incentivar|S T IY V AE R
incerteza|S IH0 R T EH0 Z AA
inchaço|SH AE S UW
incisiva|S IY Z IY V AA
incisivo|S IY Z IY V UW
incitador|S IY T AA DH OW0 R
inclinado|K L IY N AE DH UW
inclinar|K L IY N AE R
inclinação|K L IY N AA S AA W
incluso|K L UW Z UW
incolumidade|K OW0 L UW M IY D AE D ZH IY
incomparável|K P AA R AE V EH0 L
inconstante|K SH T AA T IH0
inconveniente|K V IH0 N Y T IH0
incorretamente|K UW RH EH T AA M T IH0
incorreto|K UW RH EH T UW
incrementar|K RRR EH0 M T AE R
incrível|K R IY V EH L
incumprimento|K P R IY M T UW
incêndio|S D Y UW
incómodo|K AO M UW DH UW
indecente|D IH0 S T IH0
indicador|D IY K AA DH OW0 R
indicar|D IY K AE R
indiferente|D IY F IH0 R T IH0
indiferença|D IY F IH0 R S AA
indispensável|D IY SH P S AE V EH L
indissociável|D ZH IY S OW0 S IY AE V EH0 W
indivíduo|D IY V IY D W UW
indo|D UW
indolente|D UW L T IH0
indústria|D UW SH T R Y AA
inepta|IY N EH P T AA
inepto|IY N EH P T UW
inerência|IY N EH0 R S Y AE
infame|F AE M IH0
infantaria|F AA T AA R IY AA
inferior|F IH0 R Y OW0 R
inferno|F EH R N UW
infiltração|F IY L T R AA S AA W
infindo|F D UW
infinita|F IY N IY T AA
infinitivo|F IY N IY T IY V UW
inflamatório|F L AA M AA T AO R Y UW
inflamação|F L AA M AA S AA W
inflamável|F L AA M AE V EH L
inflexível|F L EH K S IY V EH L
influência|F L W S Y AA
informação|F UW R M AA S AA W
informações|F UW R M AA S Y SH
infrassom|F R AA S
infrassónico|F R AA S AO N IY K UW
infâmia|F AA M Y AA
ingerência|ZH EH0 R S Y AE
ingratidão|G R AA T IY DH AA W
inhapa|IY N IY0 AE P AA
iniciar|IY N IY S Y AE R
inimizade|IY N IY M IY Z AE DH IH0
iniquidade|IY N IY K W IY D AE D ZH IY
injete|ZH EH T SH IY
injeção|ZH EH S AA W
injúria|ZH UW R Y AA
inocente|IY N UW S T IH0
inocência|IY N UW S S Y AA
inorgânico|IY N AO R G AA N IY K UW
inotrópico|IY N AO T R AO P IY K UW
inovar|IY N UW V AE R
inovação|IY N UW V AA S AA W
inquisição|K IY Z IY S AA W
insalubre|S AA L UW V R IH0
insano|S AA N UW
inscrição|SH K R IY S AA W
insensato|S S AE T UW
insensibilidade|S S IY V IH0 L IY DH AE DH IH0
insensivelmente|S S IY V EH L M T IH0
insensível|S S IY V EH L
inseto|S EH T UW
insistir|S IY SH T IY R
insolvente|S AO L V T IH0
inspirado|SH P IY R AE DH UW
inspirar|SH P IY R AE R
inspiração|SH P IY R AA S AA W
instalado|SH T AA L AE DH UW
instalar|SH T AA L AE R
instalação|SH T AA L AA S AA W
instantâneo|SH T AA T AA N Y UW
instigador|SH T IY HH AA D OW0 R
instruir|SH T R UW IY R
instrumento|SH T R UW M T UW
instrutor|SH T R UW T OW0 R
instrução|SH T R UW S AA W
instância|SH T AA S Y AA
insubordinação|S UW B OW0 R D ZH IY N AE S AA W
insuficiente|S UW F IY S Y T IH0
insulina|S UW L IY N AA
insumo|S UW M UW
insuportável|S UW P UW R T AE V EH L
insurreição|S UW RH AA Y S AA W
insuscetível|S UW S EH0 T SH IY V EH0 W
insígnia|S IY HH N Y AA
intacto|T AE K T UW
inteiro|T EH Y R UW
intelectual|T IH0 L EH K T W AE L
inteligente|T IH0 L IY ZH T IH0
inteligência|T IH0 L IY ZH S Y AA
intensamente|T S AA M T IH0
intento|T T UW
intenção|T S AA W
intercessor|T IH0 R S EH0 S OW0 R
intercorrência|T EH0 R K OW0 RH S Y AE
intercultural|T EH R K UW L T UW R AE L
interessar|T IH0 R IH0 S AE R
interesse|T IH0 R EH0 S IH0
interesseiro|T EH0 R EH0 S EH0 Y R UW
interferência|T IH0 R F IH0 R S Y AA
interior|T IH0 R IY OW0 R
interiorano|T EH0 R Y OW0 R AA N UW
internauta|T EH R N AE W T AA
internação|T EH0 R N AE S AA W
internet|T EH R N EH T
interrobang|T EH RH UW B AA G IH0
intimidade|T IY M IY DH AE DH IH0
intransigência|T RRR AA Z IY ZH S Y AA
introdução|T R UW D UW S AA W
intromete|T R OW0 M EH T SH IY
introspectivo|T R AO SH P EH K T IY V UW
invadir|V AE DH IY R
invariavelmente|V AA R Y AE V EH L M T IH0
invasão|V AE Z AA W
invencível|V S IY V EH L
inventar|V T AE R
invenção|V S AA W
investigador|V IH0 SH T IY HH AE DH OW0 R
investigar|V IH0 SH T IY HH AE R
investigação|V IH0 SH T IY HH AA S AA W
inviabilidade|V IY AE B IY L IY D AE D ZH IY
invocar|V UW K AE R
invólucro|V AO L UW K R UW
início|IY N IY S Y UW
iníquo|IY N IY K W UW
inútil|IY N UW T IY L
ipê|IY P EH0
ira|IY R AA
iria|IY R IY AA
irlandês|IY R L AA D EH0 SH
ironicamente|IY R AO N IY K AA M T IH0
irracionalidade|IY RH AA S Y UW N AE L IY DH AE DH IH0
irrelevante|IY RH IH0 L IH0 V AA T IH0
irrepreensível|IY RH EH0 P R EH0 S IY V EH0 W
irresponsabilidade|IY RH IH0 SH P S AA V IY L IY DH AE DH IH0
irrupção|IY RH UW P S AA W
irá|IY R AE
irã|IY R AA
irão|IY R AA W
isaura|IY Z AE W R AA
isenta|IY Z T AA
isentar|IY Z T AE R
isento|IY Z T UW
isenção|IY Z S AA W
isolação|IY Z UW L AA S AA W
isopor|IY Z OW0 P OW0 RH
isqueiro|IY SH K AA Y R UW
isso|IY S UW
itamaraty|IY T AE M AE R AE T SH IY
item|IY T EH M
itera|IY T EH RRR AE
iterar|IY T EH0 R AE R
iá|Y AE
ião|IY AA W
içado|IY S AE DH UW
içar|IY S AE R
iço|IY S UW
j|ZH AO T AA
jaca|ZH AE K AA
jacto|ZH AE T UW
jaez|ZH AA EH0 SH
jaleco|ZH AA L EH K UW
janeireiro|ZH AA N AA Y R AA Y R UW
janeirento|ZH AA N AA Y R T UW
janela|ZH AA N EH L AA
janelamento|ZH AA N IH0 L AA M T UW
janelar|ZH AA N IH0 L AE R
janelas|ZH AA N EH L AA SH
janeleiro|ZH AA N IH0 L AA Y R UW
janelinha|ZH AA N IH0 L IY N IY0 AA
janelo|ZH AA N EH0 L UW
janelão|ZH AA N IH0 L AA W
jangada|ZH AA G AE DH AA
janota|ZH AA N AO T AA
janotar|ZH AE N OW0 T AE R
janta|ZH AA T AA
jantava|ZH AA T AE V AA
japa|ZH AE P AA
japonesa|ZH AA P UW N EH0 Z AA
japonês|ZH AA P UW N EH0 SH
jaqueta|ZH AA K EH0 T AA
jardim|ZH AA R DH
jardinagem|ZH AA R DH IY N AE ZH AA Y
jardinar|ZH AA R DH IY N AE R
jardineiro|ZH AA R DH IY N AA Y R UW
jargão|ZH AA R HH AA W
jasmim|ZH AA ZH M
jaspe|ZH AE SH P IH0
jato|ZH AE T UW
jau|ZH AE W
jaula|ZH AE W L AA
java|ZH AE V AA
javali|ZH AA V AA L IY
joalharia|ZH W AA L IY AA R IY AA
joalheiro|ZH W AA L IY AA Y R UW
joaninha|ZH W AA N IY N IY0 AA
joelhos|ZH W AA Y L IY UW SH
joguetar|ZH OW0 G EH0 T AE R
joguete|ZH OW0 G EH T SH IY
joia|ZH AO Y AA
joio|ZH OW0 Y UW
jornada|ZH UW R N AE D AA
jornais|ZH UW R N AE Y SH
jornaleiro|ZH UW R N AA L AA Y R UW
jornalismo|ZH UW R N AA L IY ZH M UW
jornalista|ZH UW R N AA L IY SH T AA
jornalístico|ZH UW R N AA L IY SH T IY K UW
josé|ZH UW Z EH
jota|ZH AO T AA
ju|ZH UW
judaico|ZH UW D AE Y K UW
judaísmo|ZH UW DH AA IY SH M UW
judicial|ZH UW DH IY S Y AE L
jugo|ZH UW HH UW
juizado|ZH UW IY Z AE D UW
juju|ZH UW ZH UW
julho|ZH UW L IY UW
juliet|ZH UW L IY EH T SH IY
jumento|ZH UW M T UW
junco|ZH K UW
junta|ZH T AA
juntar|ZH T AE R
juntas|ZH T AA SH
junto|ZH T UW
juntos|ZH T UW SH
junção|ZH S AA W
jura|ZH UW R AE
juro|ZH UW R UW
juso|ZH UW Z UW
juventude|ZH UW V T UW DH IH0
juízo|ZH W IY Z UW
já|ZH AE
júnior|ZH UW N Y AO R
júpiter|ZH UW P IY T EH R
júri|ZH UW R IY
k|K AE P AA
kamikaze|K AE M IY K AE Z IH0
kan|K AE N
kilimanjaro|K IY L IY M AA ZH AE R UW
kombi|K B IY
kwanza|K W AA Z AA
kyat|K Y AE T IH0
la|L AE
laca|L AE K AA
lacra|L AE K R AA
lacro|L AE K R UW
lagos|L AE HH UW SH
laico|L AE Y K UW
laivo|L AE Y V UW
lambo|L AA B UW
lambreta|L AA B R EH0 T AA
lameira|L AE M EH0 Y R AA
lameiro|L AE M EH0 Y R UW
lamento|L AA M T UW
lamparina|L AA P AA R IY N AA
lampejo|L AA P EH ZH UW
lamúria|L AE M UW R Y AE
lancha|L AA SH AA
lanchar|L AA SH AE RRR
lande|L AA DH IH0
lanterna|L AA T EH R N AA
lança|L AA S AA
lançando|L AA S AA D UW
lanço|L AA S UW
lançou|L AA S OW0 W
lapa|L AE P AA
lapidar|L AA P IY DH AE R
laranjeira|L AA R AA ZH AA Y R AA
larga|L AE R HH AA
largamente|L AE R HH AA M T IH0
largar|L AA R HH AE R
largas|L AE R HH AA SH
largo|L AE R G UW
largos|L AE R HH UW SH
largura|L AA R HH UW R AA
larica|L AA R IY K AA
las|L AA SH
lassa|L AE S AA
lasso|L AE S UW
lata|L AE T AA
latinar|L AA T IY N AE R
lato|L AE T UW
latão|L AA T AA W
laura|L AE W R AA
lava|L AE V AA
lavagem|L AA V AE ZH AA Y
lavar|L AA V AE R
lavra|L AE V R AA
lavrar|L AA V R AE R
lazer|L AA Z EH0 R
laço|L AE S UW
lealdade|L Y AE L D AE DH IH0
lebre|L EH V R IH0
lediça|L IH0 DH IY S AA
ledo|L EH0 DH UW
legar|L IH0 G AE R
legislar|L IH0 ZH IY ZH L AE R
legislação|L IH0 ZH IY ZH L AA S AA W
legítimo|L IH0 ZH IY T IY M UW
leilão|L AA Y L AA W
leira|L AA Y R AA
leite|L AA Y T IH0
leitor|L AA Y T OW0 R
leituga|L AA Y T UW HH AA
leitura|L AA Y T UW R AA
leitão|L AA Y T AA W
lembra|L B R AA
lembram|L B R AA W
lembrando|L B R AA D UW
lembrança|L B R AA S AA
lembrava|L B R AE V AA
lembro|L B R UW
lembrou|L B R OW0 W
lenda|L D AA
lendo|L D UW
lene|L EH0 N IH0
lengalenga|L G AA L G AA
leniência|L EH0 N IY S Y AE
lenta|L T AA
lentamente|L T AA M T IH0
lento|L T UW
lentos|L T UW SH
lenço|L S UW
lençol|L S AO L
lepra|L EH P R AA
leque|L EH K IH0
lera|L EH0 R AA
lesto|L EH SH T UW
letra|L EH0 T R AA
letras|L EH0 T R AA SH
leu|L EH0 W
leva|L EH V AA
levam|L EH V AA W
levantando|L IH0 V AA T AA D UW
levantar|L IH0 V AA T AE R
levo|L EH V UW
lezíria|L IH0 Z IY R IY AA
lha|L IY AA
lhas|L IY AA SH
lho|L IY UW
lhos|L IY UW SH
li|L IY
liberação|L IY V IH0 R AA S AA W
libertar|L IY V IH0 R T AE R
libertação|L IY V IH0 R T AA S AA W
libra|L IY V R AA
libélula|L IY B EH L UW L AA
licantropo|L IY K AA T R OW0 P UW
licença|L IY S S AA
liceu|L IY S EH0 W
lichia|L IY SH IY AA
licor|L IY K OW0 R
licranço|L IY K R AA S UW
lidar|L IY DH AE R
liderar|L IY DH IH0 R AE R
ligado|L IY HH AE DH UW
ligamento|L IY HH AA M T UW
ligar|L IY HH AE R
ligação|L IY HH AA S AA W
lilongwe|L IY L G W EH
lima|L IY M AA
limitado|L IY M IY T AE DH UW
limitar|L IY M IY T AE R
limitação|L IY M IY T AA S AA W
limoeiro|L IY M W AA Y R UW
limpando|L P AA D UW
limpar|L P AE R
limpeza|L P EH0 Z AA
limpo|L P UW
limão|L IY M AA W
limítrofe|L IY M IY T R UW F IH0
linchava|L SH AE V AA
linda|L D AA
lindo|L D UW
lindos|L D UW SH
linfoma|L F OW0 M AA
linfático|L F AE T IY K UW
linfócito|L F AO S IY T UW
linguiça|L G W IY S AA
linguística|L G W IY SH T IY K AA
linha|L IY N IY0 AA
linhas|L IY N IY0 AA SH
linho|L IY N IY0 UW
lintel|L T EH L
liso|L IY Z UW
lista|L IY SH T AA
listagem|L IY S T AE ZH Y
lisura|L IY Z UW R AE
literatura|L IY T IH0 R AA T UW R AA
litrosa|L IY T R AO Z AA
livrar|L IY V R AE R
livraria|L IY V R AA R IY AA
livrava|L IY V R AE V AA
livreiro|L IY V RRR AA Y R UW
livremente|L IY V R IH0 M T IH0
livro|L IY V R UW
livros|L IY V R UW SH
livrão|L IY V R AA W
lixa|L IY SH AA
lixava|L IY SH AE V AA
lixo|L IY SH UW
lição|L IY S AA W
lo|L UW
loa|L OW0 AA
locomotiva|L OW0 K UW M UW T IY V AA
lodo|L OW0 DH UW
login|L AO G IY N IH0
loiro|L OW0 Y R UW
loiça|L OW0 Y S AA
loja|L AO ZH AA
lojista|L UW ZH IY SH T AA
lomba|L B AA
lombo|L B UW
longa|L G AA
longanimidade|L G AA N IY M IY D AE D ZH IY
longo|L G UW
longínquo|L ZH K W UW
lontra|L T R AA
lopes|L AO P IH0 SH
lorcha|L AO RRR SH AA
los|L UW SH
losango|L OW0 Z AA G UW
lotado|L UW T AE DH UW
lotar|L UW T AE R
lotear|L UW T Y AE R
louco|L OW0 W K UW
loucura|L OW0 W K UW R AA
loulé|L OW0 W L EH
louro|L OW0 W R UW
lousa|L OW0 W Z AA
lousada|L OW0 W Z AE DH AA
lousã|L OW0 W Z AA
louvar|L OW0 W V AE R
louvava|L OW0 W V AE V AA
louvor|L OW0 W V OW0 R
louça|L OW0 W S AA
lua|L UW AA
lucerna|L UW S EH R N AA
lucrar|L UW K R AE R
lucrava|L UW K R AE V AA
lucro|L UW K R UW
ludificar|L UW D IY F IY K AE R
lugarzinho|L UW HH AE R Z IY N IY0 UW
lume|L UW M IH0
luminoso|L UW M IY N OW0 Z UW
luneta|L UW N EH0 T AA
lunático|L UW N AE T IY K UW
lupa|L UW P AA
luso|L UW Z UW
lusofobia|L UW Z AO F UW V IY AA
lustre|L UW SH T R IH0
luta|L UW T AA
lutador|L UW T AA DH OW0 R
lutar|L UW T AE R
luto|L UW T UW
luva|L UW V AA
luvas|L UW V AA SH
lux|L UW K S
luxo|L UW SH UW
luxúria|L UW SH UW R Y AA
luzerna|L UW Z EH R N AA
luzes|L UW Z IH0 SH
luzidio|L UW Z IY D IY UW
luzir|L UW Z IY R
luís|L UW IY SH
lá|L AE
lácio|L AE S Y UW
lácteo|L AE K T Y UW
lágrimas|L AE HH R IY M AA SH
lápis|L AE P IY SH
lâmina|L AA M IY N AA
lâmpada|L AA P AA DH AA
lã|L AA
lémure|L EH M UW R IH0
léu|L EH W
lê|L EH0
língua|L G W AA
lípsia|L IY P S Y AA
líquido|L IY K IY DH UW
lírica|L IY R IY K AA
lírico|L IY R IY K UW
lírio|L IY R Y UW
lívido|L IY V IY DH UW
lógia|L AO ZH Y AA
lógico|L AO ZH IY K UW
lótus|L AO T UW SH
lúcia|L UW S Y AA
lúcifer|L UW S IY F EH R
ma|M AA
machado|M AA SH AE DH UW
machista|M AA SH IY SH T AA
macho|M AE SH UW
macio|M AA S IY UW
macla|M AE K L AA
maconha|M AE K OW0 N IY0 AE
macro|M AE K R UW
madre|M AE DH R IH0
madrepérola|M AE DH R IH0 P EH R UW L AA
madressilva|M AE DH R IH0 S IY L V AA
madrugada|M AA DH R UW HH AE DH AA
madrugar|M AA DH R UW HH AE R
maduro|M AE D UW R UW
mafra|M AE F R AA
magistratura|M AA ZH IY SH T R AA T UW R AA
magistério|M AE ZH IY S T EH R Y UW
magnífico|M AE G N IY F IY K UW
magoar|M AA HH W AE R
magreza|M AA HH R EH0 Z AA
magusto|M AA HH UW SH T UW
maia|M AE Y AA
mainel|M AE Y N EH L
maio|M AE Y UW
maioria|M AA Y UW R IY AA
maisena|M AE Y Z EH0 N AE
majestade|M AA ZH IH0 SH T AE DH IH0
mala|M AE L AA
malaquita|M AA L AA K IY T AA
maleficiar|M AE L EH0 F IY S IY AE R
malefício|M AE L EH0 F IY S Y UW
malha|M AE L IY AA
malho|M AE L IY UW
mali|M AE L IY
maligno|M AA L IY G N UW
maloca|M AE L AO K AE
malograr|M AE L OW0 G R AE RH
maloqueiro|M AE L OW0 K EH0 Y R UW
maluco|M AA L UW K UW
maléfico|M AA L EH F IY K UW
mamba|M AA B AA
mambembe|M AA B Y B IY
mambo|M AA B UW
mamão|M AA M AA W
manada|M AE N AE D AA
manca|M AA K AA
mancha|M AA SH AA
manchester|M AA T SH EH S T AA R
manco|M AA K UW
manda|M AA D AA
mandado|M AA D AE DH UW
mandando|M AA D AA D UW
mandar|M AA D AE R
mandato|M AA D AE T UW
mandatário|M AA D AA T AE R Y UW
mandava|M AA D AE V AA
mando|M AA D UW
mandorla|M AA D AO R L AA
mandou|M AA D OW0 W
mandíbula|M AA D IY V UW L AA
maneira|M AA N AA Y R AA
maneiras|M AA N AA Y R AA SH
maneiro|M AA N AA Y R UW
manga|M AA G AA
mangas|M AA G AA SH
mangra|M AA G R AA
mangá|M AA G AE
manicómio|M AA N IY K AO M Y UW
manifestar|M AA N IY F IH0 SH T AE R
manifestação|M AA N IY F IH0 SH T AA S AA W
manipulação|M AA N IY P UW L AA S AA W
manipulável|M AE N IY P UW L AE V EH0 L
manjar|M AA ZH AE RH
manjedoura|M AA ZH IH0 D OW0 W RRR AA
manjerico|M AA ZH IH0 R IY K UW
manjericão|M AA ZH IH0 R IY K AA W
manjerona|M AA ZH IH0 R OW0 N AA
manobra|M AA N AO V R AA
mansa|M AA S AA
mansidão|M AA S IY DH AA W
manso|M AA S UW
mansão|M AA S AA W
manta|M AA T AA
manteigas|M AA T AA Y HH AA SH
manter|M AA T EH0 R
mantimento|M AA T IY M T UW
manto|M AA T UW
mantêm|M AA T Y Y
manumissão|M AA N UW M IY S AA W
manuscrito|M AA N UW SH K R IY T UW
manuseio|M AA N UW Z AA Y UW
mapa|M AE P AA
maputo|M AA P UW T UW
maquinaria|M AA K IY N AA R IY AA
maracujá|M AA R AA K UW ZH AE
marafona|M AA R AA F OW0 N AA
marajá|M AA R AA ZH AE
marca|M AE R K AA
marcar|M AA R K AE R
marcação|M AA R K AA S AA W
marcha|M AE R SH AA
marchar|M AA R SH AE R
maresia|M AA R IH0 Z IY AA
marga|M AE R HH AA
margarida|M AA R G AA R IY D AA
margem|M AE R ZH AA Y
maria|M AA R IY AA
mariana|M AA R Y AA N AA
marinha|M AA R IY N IY0 AA
marinheiro|M AA R IY N IY0 AA Y R UW
marinho|M AA R IY N IY0 UW
marmelada|M AA R M IH0 L AE DH AA
marmelo|M AA R M EH L UW
maromba|M AE R B AE
maroto|M AA R OW0 T UW
marquês|M AA R K EH0 SH
marra|M AE RH AE
marrano|M AA RH AA N UW
marreca|M AA RH EH K UW
marreco|M AA RH EH K UW
marrom|M AA RH
marta|M AE R T AA
martelar|M AA R T IH0 L AE R
martelo|M AA R T EH L UW
martírio|M AA R T IY R Y UW
marujo|M AA R UW ZH UW
marvão|M AA R V AA W
marxista|M AE R K S IY S T AE
maré|M AA R EH
mascote|M AA SH K AO T IH0
masculinidade|M AA SH K UW L IY N IY DH AE DH IH0
masmorra|M AA ZH M OW0 RH AA
massa|M AE S AA
mastro|M AE SH T R UW
masturbação|M AE SH T UW R V AA S AA W
mata|M AE T AA
matador|M AA T AA DH OW0 R
matamatá|M AE T AE M AE T AE
matar|M AA T AE R
maternidade|M AA T IH0 R N IY DH AE DH IH0
matilda|M AA T IY L D AA
matilde|M AA T IY L D IH0
mato|M AE T UW
matrícula|M AA T R IY K UW L AA
matéria|M AA T EH R Y AA
mau|M AE W
maura|M AE W R AA
mauro|M AE W R UW
mavioso|M AE V IY OW0 Z UW
mazela|M AA Z EH L AA
maça|M AE S AA
maçaneta|M AA S AA N EH0 T AA
maço|M AE S UW
mação|M AA S AA W
mc|M EH K IY
mealhada|M IY AA L IY AE DH AA
mealheiro|M Y AA L IY AA Y R UW
meação|M Y AA S AA W
mec|M EH K IY
meca|M EH K AA
mediação|M IH0 DH Y AA S AA W
medicina|M IH0 DH IH0 S IY N AA
mediterrâneo|M IH0 D IY T IH0 RH AA N Y UW
medo|M EH0 D UW
medonho|M IH0 D OW0 N IY0 UW
medrica|M EH0 D R IY K AE
medricas|M EH0 D R IY K AE S
medrincas|M EH0 D R K AE S
medronheiro|M IH0 DH R UW N IY0 AA Y R UW
medronho|M IH0 DH R OW0 N IY0 UW
medroso|M IH0 DH R OW0 Z UW
melancia|M IH0 L AA S IY AA
melancolicamente|M IH0 L AA K AO L IY K AA M T IH0
melancólico|M IH0 L AA K AO L IY K UW
melecar|M EH0 L EH0 K AE R
melgaço|M EH L HH AE S UW
melhores|M IH0 L IY AO R IH0 SH
melindroso|M EH0 L D R OW0 Z UW
meloa|M IH0 L OW0 AA
melodia|M IH0 L UW DH IY AA
melão|M IH0 L AA W
membrana|M B R AA N AA
membro|M B R UW
memorizar|M IH0 M UW R IY Z AE R
memorização|M IH0 M UW R IY Z AA S AA W
memória|M IH0 M AO R Y AA
mencionar|M S Y UW N AE R
mendaz|M EH0 N D AE Y SH
mendigar|M D IY HH AE R
mendigo|M D IY HH UW
mene|M EH0 N IY
menina|M IH0 N IY N AA
meninas|M IH0 N IY N AA SH
menino|M IH0 N IY N UW
meninos|M IH0 N IY N UW SH
mensagem|M S AE ZH AA Y
mensalidade|M S AE L IY D AE D ZH IY
menta|M T AA
mentalidade|M T AA L IY DH AE DH IH0
mentira|M T IY R AA
menu|M EH N UW
mera|M EH R AA
mercado|M IH0 R K AE D UW
mercadologia|M IH0 R K AA DH UW L UW ZH IY AA
mercador|M IH0 R K AA DH OW0 R
mercadoria|M IH0 R K AA DH UW R IY AA
merceeiro|M IH0 R S Y AA Y R UW
mergulho|M IH0 R HH UW L IY UW
meridional|M IH0 R IY DH Y UW N AE L
merreca|M EH0 RH EH K AE
mesa|M EH0 Z AA
mesada|M IH0 Z AE DH AA
mescal|M EH SH K AE L
mesquita|M IH0 SH K IY T AA
messe|M EH S IH0
mesóclise|M EH0 Z AO K L IY Z IY
meta|M EH T AA
metade|M IH0 T AE DH IH0
metafísico|M EH T AA F IY Z IY K UW
mete|M EH T SH IY
meter|M IH0 T EH0 R
meteu|M IH0 T EH0 W
metido|M IH0 T IY DH UW
metodista|M EH0 T OW0 D ZH IY S T AA
metro|M EH T R UW
meu|M EH0 W
mi|M IY
miasma|M Y AE ZH M AA
micho|M IY SH UW
mico|M IY K UW
microclima|M IY K R AO K L IY M AA
micáceo|M IY K AE S IY UW
migrante|M IY HH R AA T IH0
migrar|M IY HH R AE R
migração|M IY HH R AA S AA W
migué|M IY G EH
mijo|M IY ZH UW
mika|M IY K AA
miki|M IY K IY
mikiko|M IY K IY K UW
milha|M IY L IY AA
milhares|M IY L IY AE R IH0 SH
milho|M IY L IY UW
milhão|M IY L IY AA W
militar|M IY L IY T AE R
mim|M
mimimi|M IY M IY M IY
mimo|M IY M UW
mimosa|M IY M AO Z AA
minako|M IY N AE K UW
mingau|M G AE W
minissaia|M IY N IY S AE Y AA
ministro|M IH0 N IY SH T R UW
minuto|M IY N UW T UW
minério|M IY N EH R Y UW
minúcia|M IY N UW S Y AE
miopatia|M IY AO P AA T IY AA
miopático|M IY AO P AE T IY K UW
mira|M IY R AA
miraculoso|M IY R AA K UW L OW0 Z UW
miradoiro|M IY R AA DH OW0 Y R UW
miradouro|M IY R AA DH OW0 W R UW
miranda|M IY R AA D AA
mirandela|M IY R AA D EH L AA
mirandês|M IY R AA D EH0 SH
mirar|M IY R AE R
mirra|M IY RH AA
mirrar|M IY RH AE R
mirtilo|M IY R T IY L UW
miríade|M IY R IY AA DH IH0
misandria|M IY Z AA D R IY AA
miserável|M IY Z IH0 R AE V EH L
missa|M IY S AA
mississippi|M IY S IY S IY P IY
missiva|M IY S IY V AA
missão|M IY S AA W
mister|M IY S T EH R
mistura|M IY SH T UW R AA
misturar|M IY SH T UW R AE R
misturo|M IY SH T UW R UW
mistério|M IY SH T EH R Y UW
miséria|M IY Z EH R Y AA
mito|M IY T UW
mitombo|M IY T B UW
mitra|M IY T R AA
mixuruca|M IY SH UW R UW K AE
miyuki|M IY Y UW K IY
mo|M UW
mobilizador|M OW0 B IY L IY Z AE D OW0 R
mobília|M UW V IY L Y AA
mocho|M OW0 SH UW
moda|M AO DH AA
modelo|M UW DH EH0 L UW
moderno|M UW DH EH R N UW
modificar|M UW DH IY F IY K AE R
modo|M AO DH UW
modos|M AO DH UW SH
mofo|M OW0 F UW
mogadouro|M UW HH AA DH OW0 W R UW
moira|M OW0 Y R AA
moirama|M OW0 Y R AA M AA
moirisma|M OW0 Y R IY ZH M AA
moita|M OW0 Y T AA
mola|M AO L AA
moldura|M UW L D UW R AA
moleiro|M UW L AA Y R UW
molhado|M UW L IY AE DH UW
molho|M AO L IY UW
momento|M UW M T UW
momice|M OW0 M IY S IY
mondar|M D AE R
monforte|M F AO R T IH0
monge|M ZH IH0
monja|M ZH AA
monocromo|M AO N AO K R AO M UW
monocromático|M AO N AO K R AO M AE T IY K UW
monogamia|M OW0 N OW0 G AA M IY AE
monogâmico|M OW0 N OW0 G AA M IY K UW
monstro|M SH T R UW
monstruoso|M S T R UW OW0 Z UW
montalegre|M T AA L EH HH R IH0
montar|M T AE R
monte|M T IH0
montevideano|M T IH0 V IY D Y AA N UW
montra|M T R AA
monturo|M T UW R UW
monumento|M UW N UW M T UW
monárquico|M UW N AE R K IY K UW
monção|M S AA W
mora|M AO R AA
morada|M UW R AE DH AA
morador|M UW R AA DH OW0 R
moradores|M UW R AA DH OW0 R IH0 SH
moraes|M OW0 R AE Y S
morais|M OW0 R AE Y S
moranga|M UW R AA G AA
morder|M UW R DH EH0 R
mordida|M UW R DH IY DH AA
mordidela|M UW R DH IY DH EH L AA
mordomo|M AO R DH OW0 M UW
more|M AO R IH0
moreira|M UW R AA Y R AA
moreno|M UW RRR EH0 N UW
moroso|M UW R OW0 Z UW
morrendo|M UW RH D UW
morrera|M UW RH EH0 R AA
morrerá|M UW RH IH0 R AE
morreu|M UW RH EH0 W
morria|M UW RH IY AA
morrido|M UW RH IY DH UW
morte|M AO R T IH0
mortos|M AO R T UW SH
mortágua|M AO R T AE HH W AA
mosaico|M UW Z AE Y K UW
mosca|M OW0 SH K AA
mosteiro|M UW SH T AA Y R UW
mostra|M AO SH T R AA
mostrando|M UW SH T R AA D UW
mostrar|M UW SH T R AE R
mostrava|M UW SH T R AE V AA
motivo|M UW T IY V UW
motor|M UW T OW0 R
mouco|M OW0 W K UW
moura|M OW0 W R AA
mourama|M OW0 W R AA M AA
mourisco|M OW0 W R IY SH K UW
mourisma|M OW0 W R IY ZH M AA
mouro|M OW0 W R UW
mourão|M OW0 W R AA W
mover|M UW V EH0 R
movimentado|M UW V IY M T AE DH UW
movimento|M UW V IY M T UW
moça|M OW0 S AA
moço|M OW0 S UW
moçárabe|M UW S AE R AA B IH0
moção|M UW S AA W
moído|M W IY DH UW
muda|M UW DH AA
mudar|M UW DH AE R
mudo|M UW DH UW
mudéjar|M UW D EH ZH AE R
mufti|M UW F T IY
mui|M Y
muita|M Y T AA
muitas|M Y T AA SH
muito|M Y T UW
muitos|M Y T UW SH
muitíssimo|M Y T IY S IY M UW
mula|M UW L AA
mulato|M UW L AE T UW
mulherão|M UW L IY EH R AA W
multidão|M UW L T IY DH AA W
multiúso|M UW L T IY UW Z UW
mundo|M D UW
mundão|M D AA W
município|M UW N IY S IY P Y UW
munir|M UW N IY R
muquifo|M UW K IY F UW
muralha|M UW R AE L IY AA
mure|M UW R IH0
murganho|M UW R HH AA N IY0 UW
murmurando|M UW R M UW R AA D UW
murmurar|M UW R M UW R AE R
murmurava|M UW R M UW R AE V AA
murmúrio|M UW R M UW R Y UW
muro|M UW R UW
muros|M UW R UW SH
murtosa|M UW R T AO Z AA
murça|M UW R S AA
musa|M UW Z AA
muscular|M UW SH K UW L AE R
museu|M UW Z EH0 W
musicista|M UW Z IY S IY SH T AA
mutar|M UW T AE R
mutação|M UW T AA S AA W
mutuca|M UW T UW K AA
muão|M W AA W
muçulmano|M UW S UW L M AA N UW
muçununga|M UW S UW N G AA
má|M AE
mácula|M AE K UW L AA
mágica|M AE ZH IY K AA
mágico|M AE ZH IY K UW
mágoa|M AE HH W AA
máquina|M AE K IY N AA
mártir|M AE R T IY R
máscara|M AE SH K AA R AA
máximo|M AE S IY M UW
mãe|M AA Y
mão|M AA W
médico|M EH DH IY K UW
mérito|M EH R IY T UW
mértola|M EH R T UW L AA
método|M EH T UW D UW
méxico|M EH SH IY K UW
míngua|M G W AA
mó|M AO
móveis|M AO V AA Y SH
mô|M OW0
música|M UW Z IY K AA
músico|M UW Z IY K UW
nababesco|N AE B AE B EH0 S K UW
nababo|N AE B AE B UW
nacionalizar|N AA S Y UW N AA L IY Z AE R
naco|N AE K UW
nadar|N AA DH AE R
nadir|N AA DH IY R
naifa|N AE Y F AA
namoro|N AE M AO R UW
naquela|N AA K EH L AA
naquelas|N AA K EH L AA SH
naquele|N AA K EH0 L IH0
naqueles|N AA K EH0 L IH0 SH
naquilo|N AA K IY L UW
narguilé|N AE RRR G IY L EH
narigudo|N AA R IY HH UW DH UW
nasa|N AE Z AA
nasceu|N AA SH S EH0 W
nascimento|N AA SH S IY M T UW
nascituro|N AE S IY T UW R UW
natalino|N AE T AE L IY N UW
natação|N AA T AA S AA W
naturalidade|N AA T UW R AA L IY DH AE DH IH0
natureza|N AA T UW R EH0 Z AA
nau|N AE W
nauta|N AE W T AA
navegador|N AA V IH0 HH AA DH OW0 R
navegar|N AA V IH0 HH AE R
navegação|N AA V IH0 HH AA S AA W
navio|N AA V IY UW
navios|N AA V IY UW SH
nazi|N AE Z IY
nazismo|N AE Z IY ZH M UW
nação|N AA S AA W
nações|N AA S Y SH
nebuloso|N IH0 V UW L OW0 Z UW
necedade|N IH0 S IH0 D AE D IH0
necessidade|N IH0 S IH0 S IY DH AE DH IH0
necessitar|N IH0 S IH0 S IY T AE R
necessário|N IH0 S IH0 S AE R Y UW
nectarina|N EH K T AA R IY N AA
negativamente|N IH0 HH AA T IY V AA M T IH0
negativo|N IH0 HH AA T IY V UW
negação|N IH0 G AA S AA W
negociar|N IH0 HH UW S Y AE R
negra|N EH0 HH R AA
negável|N IH0 HH AE V EH L
negócios|N IH0 HH AO S Y UW SH
nela|N EH L AA
nelas|N EH L AA SH
nele|N EH0 L IH0
neles|N EH0 L IH0 SH
nenhuma|N IH0 N IY0 UW M AA
nenhures|N IH0 N IY0 UW R IH0 SH
nepotismo|N IH0 P UW T IY ZH M UW
neptuno|N EH P T UW N UW
neri|N EH0 R IY
nero|N EH R UW
nervo|N EH0 R V UW
nescidade|N IH0 SH S IY D AE D IH0
nessa|N EH S AA
nessas|N EH S AA SH
nesse|N EH0 S IH0
nesses|N EH0 S IH0 SH
nesta|N EH SH T AA
nestas|N EH SH T AA SH
neste|N EH0 SH T IH0
neta|N EH T AA
neto|N EH T UW
neve|N EH V IH0
nexo|N EH K S UW
neónio|N Y AO N Y UW
nhoca|N IY0 AO K AA
nica|N IY K AA
niceno|N IY S EH0 N UW
nicho|N IY SH UW
nilo|N IY L UW
nim|N
nimbo|N B UW
ninfa|N F AA
ninguém|N G Y
ninho|N IY N IY0 UW
ninjete|N ZH EH T SH IY
nisa|N IY Z AA
nisso|N IY S UW
nisto|N IY SH T UW
nix|N IY K S
no|N UW
nobre|N AO V R IH0
nobreza|N UW V R EH0 Z AA
nobélio|N UW V EH L Y UW
noia|N AO Y AA
noiturno|N OW0 Y T UW R N UW
noiva|N OW0 Y V AA
noivo|N OW0 Y V UW
nojeira|N OW0 ZH EH0 Y R AE
nojo|N OW0 ZH UW
nom|N
nomear|N UW M Y AE R
nomeação|N UW M Y AA S AA W
nominativo|N UW M IY N AA T IY V UW
nona|N OW0 N AA
nora|N AO R AA
nordeste|N AO R DH EH SH T IH0
normais|N AO R M AE Y SH
normalizar|N AO R M AA L IY Z AE R
noroeste|N AO R W EH SH T IH0
nosocómio|N AO Z AO K AO M Y UW
nossa|N AO S AA
nosso|N AO S UW
nostalgia|N UW SH T AE L ZH IY AA
nota|N AO T AA
notas|N AO T AA SH
noticiário|N UW T IY S Y AE R Y UW
notário|N UW T AE R Y UW
notícia|N UW T IY S Y AA
notícias|N UW T IY S Y AA SH
noutra|N OW0 W T R AA
noutras|N OW0 W T R AA SH
noutro|N OW0 W T R UW
noutros|N OW0 W T R UW SH
nova|N AO V AA
novaes|N OW0 V AE Y S
novais|N OW0 V AE Y S
novena|N UW V EH0 N AA
novidade|N UW V IY DH AE DH IH0
novinha|N UW V IY N IY0 AA
novo|N OW0 V UW
novíssima|N UW V IY S IY M AA
noção|N UW S AA W
nu|N UW
nua|N UW AA
nuca|N UW K AA
nudez|N UW DH EH0 SH
nulidade|N UW L IY DH AE DH IH0
num|N
numa|N UW M AA
numas|N UW M AA SH
numera|N UW M EH R AA
numero|N UW M EH R UW
numérico|N UW M EH R IY K UW
nunca|N K AA
nuns|N SH
nuvens|N UW V AA Y SH
nyx|N IY K S
nágua|N AE G W AE
não|N AA W
né|N EH
néscio|N EH SH S Y UW
nítido|N IY T IY D UW
nível|N IY V EH L
nó|N AO
nóbrega|N AO B R EH0 G AE
nós|N AO SH
núbil|N UW V IY L
número|N UW M IH0 R UW
números|N UW M IH0 R UW SH
obedecer|AO B IH0 D IH0 S EH0 R
obesidade|AO B IH0 Z IY D AE D IH0
obeso|AO B EH0 Z UW
objetividade|AO B ZH EH T IY V IY D AE D IH0
objetivo|AO B ZH EH T IY V UW
objeto|AO B ZH EH T UW
objeção|AO B ZH EH S AA W
oboé|OW0 V W EH
obreiro|AO V R AA Y R UW
obrigada|AO V R IY HH AE DH AA
obrigação|AO V R IY HH AA S AA W
obsceno|AO B SH S EH0 N UW
obscuridade|AO B SH K UW R IY DH AE DH IH0
obscuro|AO B SH K UW R UW
observar|AO B S IH0 R V AE R
observatório|AO B S IH0 R V AA T AO R Y UW
observação|AO B S IH0 R V AA S AA W
obstante|AO B SH T AA T IH0
obtenção|AO B T S AA W
obter|AO B T EH0 R
oca|OW0 K AA
ocarina|AO K AA RRR IY N AA
ocasião|AO K AA Z Y AA W
oceano|AO S Y AA N UW
oceanário|AO S Y AA N AE R Y UW
ociosidade|AO S Y UW Z IY DH AE DH IH0
ocioso|AO S Y OW0 Z UW
oco|OW0 K UW
octógono|AO K T AO HH UW N UW
odiana|AO D Y AA N AA
odin|AO DH
odor|AO DH OW0 R
oficializar|AO F IY S Y AA L IY Z AE R
ofício|AO F IY S Y UW
ogano|AO HH AA N UW
oi|OW0 Y
oie|OW0 Y EH0
oitava|OW0 Y T AE V AA
oitavo|OW0 Y T AE V UW
oiteiro|OW0 Y T AA Y R UW
oitenta|OW0 Y T T AA
oito|OW0 Y T UW
oiço|OW0 Y S UW
olaria|AO L AA R IY AA
oleiros|OW0 L AA Y R UW SH
olha|AO L IY AA
olhado|AO L IY AE D UW
olham|AO L IY AA W
olhamos|AO L IY AA M UW SH
olhando|AO L IY AA D UW
olhara|AO L IY AE R AA
olharam|AO L IY AE R AA W
olharei|AO L IY AA R AA Y
olharia|AO L IY AA R IY AA
olhará|AO L IY AA R AE
olhaste|AO L IY AE SH T IH0
olhava|AO L IY AE V AA
olhei|AO L IY AA Y
olhinho|AO L IY IY N IY0 UW
olhinhos|AO L IY IY N IY0 UW SH
olho|AO L IY UW
olhou|AO L IY OW0 W
olhão|AO L IY AA W
olhões|AO L IY Y SH
oliveira|AO L IY V AA Y R AA
olvidar|AO L V IY DH AE R
olá|AO L AE
ombro|B R UW
ombros|B R UW SH
omitir|AO M IY T IY R
omnisciência|AO M N IY SH S Y S Y AA
onda|D AA
ondulado|D UW L AE DH UW
ondular|D UW L AE R
onomatopeia|AO N AO M AA T UW P AA Y AA
onça|S AA
operário|AO P IH0 R AE R Y UW
optar|AO P T AE R
optativo|AO P T AA T IY V UW
opção|AO P S AA W
ora|AO R AA
ordeiro|AO R DH AA Y R UW
ordenado|AO R DH IH0 N AE DH UW
ordenar|AO R DH IH0 N AE R
ordenação|AO R DH IH0 N AA S AA W
orelhas|AO R AA Y L IY AA SH
orgulhar|AO R G UW L IY AE R
original|AO R IY ZH IY N AE L
oriundo|AO R IY D UW
orixá|OW0 R IY SH AE
orlando|AO R L AA D UW
orquestra|AO R K EH SH T R AA
orquídea|AO R K IY DH Y AA
ortiga|AO RRR T IY G AA
ortigas|AO RRR T IY G AA SH
orégano|UW R EH HH AA N UW
os|UW SH
osso|OW0 S UW
ossos|AO S UW SH
ou|OW0 W
ourela|OW0 W R EH L AE
ourique|OW0 W R IY K IH0
ourives|OW0 W R IY V IH0 SH
ouriço|OW0 W R IY S UW
ouro|OW0 W R UW
outeiro|OW0 W T AA Y R UW
outra|OW0 W T R AA
outro|OW0 W T R UW
outrora|OW0 W T R AO R AA
ouvi|OW0 W V IY
ouvido|OW0 W V IY DH UW
ouvindo|OW0 W V D UW
ouvir|OW0 W V IY R
ouvira|OW0 W V IY R AA
ouvirá|OW0 W V IY R AE
ouvisto|OW0 W V IY SH T UW
ouviu|OW0 W V IY W
ova|AO V AA
ovo|OW0 V UW
ovos|AO V UW SH
oxiúro|OW0 K S IY UW R UW
ozono|AO Z OW0 N UW
ozónio|AO Z AO N Y UW
pabulagem|P AE B UW L AE ZH Y
paciente|P AA S Y T IH0
pacificar|P AA S IY F IY K AE R
paciência|P AA S Y S Y AA
pacto|P AE K T UW
pactuar|P AA K T W AE R
pacóvio|P AE K AO V Y UW
padeiro|P AE D AA Y R UW
padoca|P AE D AO K AE
padroeiro|P AA DH R W AA Y R UW
pagode|P AA HH AO DH IH0
pagão|P AA HH AA W
pai|P AE Y
painço|P AA S UW
paio|P AE Y UW
pairar|P AE Y R AE R
paisagem|P AE Y Z AE ZH AA Y
paixão|P AE Y SH AA W
paizinho|P AE Y Z IY N IY0 UW
paizão|P AE Y Z AA W
pajem|P AE ZH Y
pajubá|P AE ZH UW B AE
pala|P AE L AA
palacete|P AA L AA S EH0 T IH0
paladar|P AA L AA DH AE R
palanquim|P AE L AA K
palavra|P AA L AE V R AA
palavras|P AA L AE V R AA SH
palavrinha|P AA L AA V R IY N IY0 AA
palavrão|P AA L AA V R AA W
palear|P AA L Y AE R
palha|P AE L IY AA
palito|P AA L IY T UW
palácio|P AA L AE S Y UW
palíndromo|P AA L D RRR UW M UW
panca|P AA K AA
pancreático|P AA K R Y AE T IY K UW
panda|P AA D AA
pandeiro|P AA D AA Y R UW
pandora|P AA D AO R AA
panela|P AA N EH L AA
panfleto|P AA F L EH0 T UW
panos|P AA N UW SH
panqueca|P AA K EH K AA
pantera|P AA T EH R AA
pantomima|P AA T UW M IY M AA
pança|P AA S AA
papa|P AE P AA
papagaio|P AA P AA HH AE Y UW
paparicar|P AA P AA R IY K AE R
paparicho|P AE P AE R IY SH UW
paparrotão|P AE P AE RH OW0 T AA W
papelão|P AA P IH0 L AA W
papo|P AE P UW
papoila|P AA P OW0 Y L AA
papoula|P AA P OW0 W L AA
papão|P AA P AA W
papéis|P AA P EH Y SH
paquerar|P AE K EH0 R AE RH
para|P AA R AA
parado|P AA R AE DH UW
parafuso|P AA R AA F UW Z UW
parando|P AA R AA D UW
parapeito|P AA R AA P AA Y T UW
paraquedas|P AE R AA K EH DH AA SH
parara|P AA R AE R AA
parará|P AA R AA R AE
parceiro|P AA R S AA Y R UW
parcelar|P AA R S IH0 L AE R
pardo|P AE R DH UW
parece|P AA R EH S IH0
pareceu|P AA R IH0 S EH0 W
parecia|P AA R IH0 S IY AA
pareciam|P AA R IH0 S IY AA W
parecido|P AA R IH0 S IY DH UW
parede|P AA R EH0 DH IH0
paredes|P AA R EH0 DH IH0 SH
parestesia|P AE R EH0 SH T EH0 Z IY AE
parlapatice|P AE R L AE P AE T SH IY S IY
parlapatão|P AE R L AE P AE T AA W
parlar|P AA R L AE R
parolar|P AA R UW L AE R
parou|P AA R OW0 W
parque|P AE R K IH0
parra|P AE RH AE
parrudo|P AE RH UW D UW
partezinha|P AA R T IH0 Z IY N IY0 AA
participar|P AA R T IY S IY P AE R
partida|P AA R T IY DH AA
partido|P AA R T IY DH UW
partidário|P AA R T IY DH AE R Y UW
partir|P AA R T IY R
partícula|P AA R T IY K UW L AA
parvo|P AE R V UW
pascácio|P AE S K AE S Y UW
paspalho|P AA SH P AE L IY UW
passa|P AE S AA
passado|P AA S AE DH UW
passados|P AA S AE DH UW SH
passagem|P AA S AE ZH AA Y
passando|P AA S AA D UW
passara|P AA S AE R AA
passaralho|P AA S AA RRR AA L IY UW
passaram|P AA S AE R AA W
passarinheiro|P AA S AA R IY N IY0 AA Y R UW
passarinho|P AA S AA R IY N IY0 UW
passará|P AA S AA R AE
passava|P AA S AE V AA
passeando|P AA S Y AA D UW
passear|P AA S Y AE R
passeio|P AA S AA Y UW
passo|P AE S UW
passos|P AE S UW SH
passou|P AA S OW0 W
pastar|P AA SH T AE R
pastelaria|P AA SH T IH0 L AA R IY AA
pasteleiro|P AA SH T IH0 L AA Y R UW
pasto|P AE SH T UW
pastor|P AA SH T OW0 R
patamar|P AA T AA M AE R
patas|P AE T AA SH
patinete|P AE T SH IY N EH T SH IY
pato|P AE T UW
patota|P AE T AO T AA
patrazana|P AE T R AE Z AA N AE
patriarca|P AA T R IY AE R K AA
patrocinar|P AA T R UW S IY N AE R
patrono|P AA T R OW0 N UW
patrão|P AA T R AA W
patrício|P AA T R IY S Y UW
patético|P AE T EH T IY K UW
patê|P AE T EH0
pau|P AE W
paula|P AE W L AA
paulo|P AE W L UW
pausa|P AE W Z AA
pauso|P AE W Z UW
pauta|P AE W T AA
pavimento|P AA V IY M T UW
pavão|P AA V AA W
pavê|P AE V EH0
pazes|P AE Z IH0 SH
paço|P AE S UW
pc|P EH0 S EH0
pec|P EH K IY
peca|P EH K AA
pecado|P IH0 K AE DH UW
pedido|P IH0 DH IY DH UW
pedra|P EH DH R AA
pedraria|P IH0 DH R AA R IY AA
pedras|P EH DH R AA SH
pedregulho|P IH0 DH R IH0 HH UW L IY UW
pedreira|P IH0 DH R AA Y R AA
pedreiro|P IH0 DH R AA Y R UW
pegajoso|P IH0 HH AA ZH OW0 Z UW
peguete|P EH0 G EH T SH IY
pela|P EH L AA
pelado|P IH0 L AE DH UW
pelar|P IH0 L AE R
pelas|P EH0 L AA SH
pelo|P IH0 L UW
pelos|P EH0 L UW SH
pelourinho|P IH0 L OW0 W R IY N IY0 UW
pelouro|P IH0 L OW0 W R UW
peluche|P IH0 L UW SH IH0
penacova|P IH0 N AA K AO V AA
penamacor|P EH0 N AA M AA K OW0 R
penar|P IH0 N AE R
pender|P D EH0 R
pendurar|P D UW R AE R
pendão|P D AA W
penedono|P IH0 N IH0 DH OW0 N UW
penela|P IH0 N EH L AA
penha|P AA N IY0 AA
penhascos|P IH0 N IY0 AE SH K UW SH
penicilina|P IH0 N IY S IY L IY N AA
penico|P IH0 N IY K UW
peninsular|P EH0 N S UW L AE R
penitência|P IH0 N IY T S Y AA
pensa|P S AA
pensam|P S AA W
pensamento|P S AA M T UW
pensamentos|P S AA M T UW SH
pensando|P S AA D UW
pensara|P S AE R AA
pensaram|P S AE R AA W
pensativo|P S AA T IY V UW
pensava|P S AE V AA
penso|P S UW
pensoso|P S OW0 Z UW
pensou|P S OW0 W
penteado|P T Y AE DH UW
pentear|P T Y AE R
pentelho|P T AA Y L IY UW
pentágono|P T AE HH UW N UW
penumbra|P IH0 N B R AA
pera|P EH R AA
peraí|P EH R AE IY
perca|P EH R K AA
perceber|P IH0 R S IH0 B EH0 R
percorrer|P IH0 R K UW RH EH0 R
perda|P EH0 R DH AA
perdida|P IH0 R DH IY DH AA
perdidamente|P IH0 R DH IY DH AA M T IH0
perdido|P IH0 R DH IY DH UW
perdição|P IH0 R DH IY S AA W
perdoar|P IH0 R D W AE R
perdulário|P EH0 R D UW L AE R Y UW
perdão|P IH0 R D AA W
perecibilidade|P EH0 RRR EH0 S IY B IY L IY D AE D ZH IY
perene|P IH0 R EH N IH0
perentoriamente|P IH0 R T AO R Y AA M T IH0
perentório|P IH0 R T AO R Y UW
perfeitamente|P IH0 R F AA Y T AA M T IH0
perfeição|P IH0 R F AA Y S AA W
perigo|P IH0 R IY HH UW
perigoso|P IH0 R IY HH OW0 Z UW
permanecer|P IH0 R M AA N IH0 S EH0 R
permitir|P IH0 R M IY T IY R
pernas|P EH R N AA SH
pernóstico|P EH0 R N AO S T SH IY K UW
pero|P EH R UW
perplexo|P EH0 RH P L EH K S UW
perro|P EH0 RH UW
persa|P EH R S AA
perseguir|P IH0 R S IH0 HH IY R
perseguição|P IH0 R S IH0 HH IY S AA W
perspetiva|P IH0 R SH P EH T IY V AE
perspetivar|P IH0 R SH P EH T IY V AE R
pertencer|P IH0 R T S EH0 R
perturbado|P IH0 R T UW R V AE DH UW
perturbador|P IH0 R T UW R V AE DH OW0 R
perturbar|P EH0 RRR T UW RRR B AE RRR
perturbação|P IH0 R T UW R V AA S AA W
peru|P IH0 R UW
peruca|P IH0 R UW K AA
perversão|P IH0 R V IH0 R S AA W
período|P IH0 R IY UW DH UW
pesadelo|P IH0 Z AA D EH0 L UW
pesado|P IH0 Z AE DH UW
pesados|P IH0 Z AE DH UW SH
pesagem|P IH0 Z AE ZH AA Y
pesar|P IH0 Z AE R
pesca|P EH SH K AA
pescador|P IH0 SH K AA DH OW0 R
pescoço|P IH0 SH K OW0 S UW
peso|P EH Z UW
pesquisar|P IH0 SH K IY Z AE R
pessoa|P EH S OW0 AE
pestana|P IH0 SH T AA N AA
pestanas|P IH0 SH T AA N AA SH
peste|P EH SH T IH0
peteminion|P EH0 T EH0 M IY N Y
petróleo|P IH0 T R AO L Y UW
petúnia|P IH0 T UW N Y AA
pezinho|P EH Z IY N IY0 UW
peça|P EH S AA
pi|P IY
pia|P IY AA
pianinho|P IY AA N IY N IY0 UW
piano|P Y AA N UW
picadeiro|P IY K AE D EH0 Y R UW
picareta|P IY K AA R EH0 T AA
pichação|P IY SH AE S AA W
picho|P IY SH UW
pico|P IY K UW
picolé|P IY K OW0 L EH
piedade|P Y EH D AE D IH0
piedoso|P Y EH DH OW0 Z UW
piemonte|P Y IH0 M T IH0
piemontês|P Y EH0 M T EH0 SH
pigídio|P IY ZH IY D Y UW
pila|P IY L AA
pilha|P IY L IY AA
pilhão|P IY L IY AA W
pilo|P IY L UW
piloro|P IY L OW0 R UW
piloto|P IY L AO T UW
pilão|P IY L AA W
pimenta|P IY M T AA
pimento|P IY M T UW
pimentão|P IY M T AA W
pimpão|P P AA W
pingo|P G UW
pingolim|P G UW L
pinguim|P G W
pinha|P IY N IY0 AA
pinoia|P IY N AO Y AE
pinque|P K IH0
pinta|P T AA
pintar|P T AE R
pinto|P T UW
pintor|P T OW0 R
pintura|P T UW R AA
pinturesco|P T UW R EH0 SH K UW
piorar|P Y UW R AE R
pipa|P IY P AA
pipi|P IY P IY
pipoca|P IY P AO K AA
pique|P IY K IY
pira|P IY R AA
pirata|P IY R AE T AA
pires|P IY R IH0 SH
piriguete|P IY R IY G EH T SH IY
pirilampo|P IY R IY L AA P UW
piriri|P IY R IY R IY
pirita|P IY R IY T AA
piroca|P IY R AO K AA
piroxena|P IY R AO K S EH N AA
pirralho|P IY RH AE L IY UW
piru|P IY R UW
pirão|P IY R AA W
pisa|P IY Z AA
piso|P IY Z UW
pistola|P IY SH T AO L AA
pitaco|P IY T AE K UW
pitanga|P IY T AA G AA
pito|P IY T UW
pitoresco|P IY T UW R EH0 SH K UW
pitu|P IY T UW
pitão|P IY T AA W
pitéu|P IY T EH W
pivete|P IY V EH T SH IY
pivô|P IY V OW0
pixulé|P IY SH UW L EH
piza|P IY Z AA
pizza|P IY Z AA
pião|P Y AA W
piça|P IY S AA
placebo|P L AE S EH0 B UW
placenta|P L AE S T AA
planear|P L AA N Y AE R
planeta|P L AA N EH0 T AA
plano|P L AA N UW
planta|P L AA T AA
plantar|P L AA T AE R
plantação|P L AA T AA S AA W
plantão|P L AA T AA W
plataforma|P L AA T AA F AO R M AA
plateia|P L AA T EH Y AA
platão|P L AA T AA W
platô|P L AE T OW0
pleito|P L EH0 Y T UW
plotador|P L OW0 T AE D OW0 RH
plotadora|P L OW0 T AE D OW0 R AE
plotagem|P L OW0 T AE ZH AA
plutão|P L UW T AA W
plutónio|P L UW T AO N IY UW
plátano|P L AE T AA N UW
pneu|P N EH0 W
poaense|P OW0 AE S IY
pobre|P AO V R IH0
pobres|P AO V R IH0 SH
pobreza|P UW V R EH0 Z AA
pobrezinho|P AO V R IH0 Z IY N IY0 UW
poderoso|P UW DH IH0 R OW0 Z UW
podre|P OW0 DH R IH0
podrão|P OW0 D R AA W
poeira|P W AA Y R AA
poema|P W EH0 M AA
poente|P W T IH0
poesia|P W EH Z IY AA
poeta|P W EH T AA
poetisa|P W EH T IY Z AA
poio|P OW0 Y UW
polaina|P UW L AE Y N AA
poliamor|P AO L IY AA M OW0 R
poliana|P OW0 L IY AA N AA
poliandria|P OW0 L IY AA D R IY AE
poliban|P AO L IY B AA
polichinelo|P UW L IY SH IY N EH L UW
policromático|P AO L IY K R AO M AE T IY K UW
polido|P UW L IY DH UW
poligamia|P OW0 L IY G AA M IY AE
poliginia|P OW0 L IY ZH IY N IY AE
poligâmico|P OW0 L IY G AA M IY K UW
polimento|P UW L IY M T UW
polir|P UW L IY R
polissintético|P AO L IY S T EH T IY K UW
poliuria|P AO L IY UW R IY AE
polivalente|P OW0 L IY V AE L T SH IY
poliúria|P AO L IY UW R Y AE
polo|P AO L UW
poltrona|P UW L T R OW0 N AA
poluir|P UW L W IY R
poluição|P UW L W IY S AA W
polução|P UW L UW S AA W
polvilho|P AO L V IY L IY UW
polvo|P OW0 L V UW
polícia|P UW L IY S Y AA
políptico|P UW L IY P T IY K UW
política|P UW L IY T IY K AA
político|P UW L IY T IY K UW
pomada|P UW M AE DH AA
pomba|P B AA
pompom|P P
poncho|P SH UW
pondera|P D EH R AA
pondo|P D UW
ponta|P T AA
pontapé|P T AA P EH
pontas|P T AA SH
ponte|P T IH0
ponteiro|P T AA Y R UW
pontiagudo|P T Y AA HH UW DH UW
ponto|P T UW
pontuar|P T W AE R
pontuação|P T W AA S AA W
popularizar|P UW P UW L AA R IY Z AE R
população|P UW P UW L AA S AA W
por|P UW R
porca|P AO R K AA
porcaria|P UW R K AA R IY AA
porcos|P AO R K UW SH
pornografia|P UW R N UW G R AE F IY AA
porongo|P UW R G UW
porque|P UW R K IH0
portada|P UW R T AE DH AA
portefólio|P AO RRR T F AO L Y UW
porteiro|P UW R T AA Y R UW
portel|P UW R T EH L
portinha|P AO R T IY N IY0 AA
portona|P AO R T OW0 N AA
portugueses|P UW R T UW HH EH0 Z IH0 SH
portuguesismo|P UW R T UW HH IH0 Z IY ZH M UW
português|P UW R T UW HH EH0 SH
portunhol|P UW R T UW N IY0 AO L
portão|P UW R T AA W
porventura|P UW R V T UW R AA
positivo|P UW Z IY T IY V UW
posição|P UW Z IY S AA W
possa|P AO S AA
posse|P AO S IH0
possibilidade|P UW S IY B IY L IY D AE D IH0
possibilitar|P UW S IY V IY L IY T AE R
posso|P AO S UW
possível|P UW S IY V EH L
posterioridade|P UW SH T IH0 R Y OW0 R IY DH AE DH IH0
posteriormente|P UW SH T IH0 R Y OW0 R M T IH0
postigo|P UW SH T IY HH UW
potencialidade|P OW0 T S Y AE L IY D AE D ZH IY
potra|P OW0 T R AA
potro|P OW0 T R UW
pouca|P OW0 W K AA
pouco|P OW0 W K UW
poupa|P OW0 W P AA
poupança|P OW0 W P AA S AA
pouquíssimo|P OW0 W K IY S IY M UW
pousada|P OW0 W Z AE DH AA
pousado|P OW0 W Z AE DH UW
pousando|P OW0 W Z AA D UW
poveiro|P AO V EH0 Y R UW
povo|P OW0 V UW
povoação|P UW V UW AA S AA W
povos|P AO V UW S
poça|P AO S AA
poço|P OW0 S UW
poção|P UW S AA W
pra|P R AA
praia|P R AE Y AA
prancha|P R AA SH AA
pranto|P R AA T UW
prata|P R AE T AA
prateado|P R AA T Y AE DH UW
prateleira|P R AA T IH0 L AA Y R AA
praticabilidade|P RRR AE T SH IY K AE B IY L IY D AE D ZH IY
prato|P R AE T UW
prazenteiro|P R AA Z T AA Y R UW
prazer|P R AA Z EH0 R
prazo|P R AE Z UW
praça|P R AE S AA
prece|P R EH S IH0
precedente|P R IH0 S IH0 DH T IH0
precioso|P R IH0 S Y OW0 Z UW
precipitadamente|P R IH0 S IY P IY T AE DH AA M T IH0
precisão|P R IH0 S IY Z AA W
preconceito|P R IH0 K S AA Y T UW
predela|P R IH0 DH EH L AA
preeminência|P RRR EH0 EH0 M IY N S Y AE
prefeito|P R IH0 F AA Y T UW
preferir|P R IH0 F IH0 R IY R
prega|P R EH HH AA
pregador|P R IH0 HH AA DH OW0 R
preju|P R EH0 ZH UW
prejudicar|P R IH0 ZH UW DH IY K AE R
prejuízo|P R IH0 ZH W IY Z UW
prelado|P R IH0 L AE DH UW
premente|P R EH0 M T SH IY
premiar|P R IH0 M Y AE R
prenda|P R D AA
prender|P R D EH0 R
prensa|P R S AA
preocupar|P R Y AO K UW P AE R
preocupação|P R Y AO K UW P AA S AA W
preparado|P R IH0 P AA R AE DH UW
preparar|P R IH0 P AA R AE R
preparação|P R IH0 P AA R AA S AA W
prepotência|P R EH P OW0 T S Y AE
presa|P R EH0 Z AA
prescritível|P R EH0 S K RRR IY T SH IY V EH0 W
presente|P R IH0 Z T IH0
presentear|P R IH0 Z T Y AE R
presença|P R IH0 Z S AA
presepada|P R EH0 Z EH0 P AE D AE
preservação|P R IH0 Z IH0 R V AA S AA W
presilha|P R IY Z IY L IY AA
preso|P R EH0 Z UW
pressa|P R EH S AA
pressionar|P R IH0 S Y UW N AE R
pressão|P R IH0 S AA W
presumir|P R IH0 Z UW M IY R
presunto|P R IH0 Z T UW
presépio|P R IH0 Z EH P Y UW
preta|P R EH0 T AA
pretexto|P R IH0 T AA Y SH T UW
pretinho|P R IH0 T IY N IY0 UW
preto|P R EH0 T UW
prevenção|P R IH0 V S AA W
previsto|P R IH0 V IY SH T UW
previsão|P R IH0 V IY Z AA W
preço|P R EH0 S UW
primaveril|P R IY M AA V IH0 R IY L
primeira|P R IY M AA Y R AA
primeiras|P R IY M AA Y R AA SH
primeiros|P R IY M AA Y R UW SH
princesa|P R S EH0 Z AA
principiar|P RRR S IY P Y AE RRR
principiou|P R S IY P IY OW0 W
princípio|P R S IY P Y UW
princípios|P R S IY P Y UW S
prisioneiro|P R IY Z Y UW N AA Y R UW
prisão|P R IY Z AA W
privar|P R IY V AE R
privatizar|P R IY V AA T IY Z AE R
privação|P R IY V AA S AA W
proa|P RRR OW0 AA
probabilidade|P R UW V AA V IY L IY DH AE DH IH0
problematizar|P R UW V L IH0 M AA T IY Z AE R
problemático|P R UW V L IH0 M AE T IY K UW
procedência|P R UW S IH0 DH S Y AA
processar|P R UW S IH0 S AE R
processo|P R UW S EH S UW
procissão|P R UW S IY S AA W
procura|P R AO K UW R AA
procurando|P R AO K UW R AA D UW
procurar|P R AO K UW R AE R
procurava|P R AO K UW R AE V AA
procuro|P R OW0 K UW R UW
produtor|P R UW DH UW T OW0 R
produzir|P R UW D UW Z IY R
produção|P R UW DH UW S AA W
proeminência|P RRR OW0 EH0 M IY N S Y AE
profe|P R AO F IH0
profecia|P R UW F IH0 S IY AA
profissional|P R UW F IY S Y UW N AE L
profundidade|P R UW F D IY DH AE DH IH0
profundo|P R UW F D UW
profícuo|P R OW0 F IY K W UW
programador|P R UW HH R AA M AA DH OW0 R
progresso|P R UW HH R EH S UW
proibido|P R UW IY V IY DH UW
proibição|P R UW Y V IY S AA W
projete|P R OW0 ZH EH T SH IY
promete|P R OW0 M EH T SH IY
pronto|P R T UW
pronuncia|P R UW N S IY AA
pronunciar|P R UW N S Y AE R
pronúncia|P R UW N S Y AA
propiciar|P RRR UW P IY S Y AE RRR
proposição|P R UW P UW Z IY S AA W
proposta|P R UW P AO SH T AA
propriedade|P R UW P R IY EH DH AE DH IH0
proprietário|P R UW P R IY EH T AE R Y UW
propósito|P R UW P AO Z IY T UW
prosa|P R AO Z AA
prostituta|P R AO SH T IY T UW T AA
proteger|P R UW T IH0 ZH EH0 R
protelar|P R OW0 T EH0 L AE R
protestar|P R UW T IH0 SH T AE R
protesto|P R UW T EH SH T UW
proteína|P R UW T IY IY N AA
protista|P RRR AO T IY SH T AA
protão|P RRR AO T AA W
prova|P R AO V AA
provavelmente|P R UW V AE V EH L M T IH0
provincial|P R UW V S Y AE L
provinha|P R UW V IY N IY0 AA
provocador|P R UW V UW K AA D OW0 R
provocar|P R UW V UW K AE R
provocatório|P R UW V UW K AA T AO R Y UW
provável|P R UW V AE V EH L
província|P R UW V S Y AA
proxy|P R AO K S IY
prudente|P R UW D T IH0
prudência|P R UW DH S Y AA
prácrito|P R AE K R IY T UW
prático|P R AE T IY K UW
pró|P R AO
próclise|P R AO K L IY Z IY
prólogo|P R AO L UW HH UW
próprias|P R AO P R Y AA SH
próprios|P R AO P R Y UW SH
próxima|P R AO S IY M AA
próximo|P R AO S IY M UW
prússia|P R UW S Y AE
psicolinguística|P S IY K AO L G W IY SH T IY K AA
psicolinguístico|P S IY K AO L G W IY SH T IY K UW
psicologia|P S IY K OW0 L OW0 ZH IY AE
psicológico|P S IY K OW0 L AO ZH IY K UW
psicóloga|P S IY K AO L OW0 G AE
psicólogo|P S IY K AO L OW0 G UW
psiquiatria|P S IY K IY AE T R IY AE
psiquê|P S IY K EH0
pua|P UW AA
publicamente|P UW V L IY K AA M T IH0
publicano|P UW V L IY K AA N UW
publicar|P UW V L IY K AE R
publicidade|P UW V L IY S IY DH AE DH IH0
publicitado|P UW V L IY S IY T AE DH UW
publicitar|P UW V L IY S IY T AE R
pueril|P W EH R IY L
pugnar|P UW HH IH0 N AE R
pulava|P UW L AE V AA
pulha|P UW L IY AA
pulsar|P UW L S AE R
pulsação|P UW L S AA S AA W
pulseira|P UW L S AA Y R AA
puma|P UW M AA
punheta|P UW N IY0 EH0 T AA
punhete|P UW N IY0 EH T SH IY
punhos|P UW N IY0 UW SH
pupila|P UW P IY L AA
pureza|P UW R EH0 Z AA
purga|P UW R HH AA
purificar|P UW R IY F IY K AE R
puro|P UW R UW
purulento|P UW R UW L T UW
puré|P UW R EH
pusera|P UW Z EH R AA
puseram|P UW Z EH R AA W
puto|P UW T UW
puxa|P UW SH AA
puxando|P UW SH AA D UW
puxar|P UW SH AE R
puxou|P UW SH OW0 W
pá|P AE
página|P AE ZH IY N AA
páli|P AE L IY
pálido|P AE L IY DH UW
pátio|P AE T Y UW
pátria|P AE T R Y AA
pânico|P AA N IY K UW
pântano|P AA T AA N UW
pã|P AA
pão|P AA W
pé|P EH
pénis|P EH N IY SH
pérola|P EH R AO L AE
pê|P EH0
pílula|P IY L UW L AA
pó|P AO
pólux|P AO L UW K S
pós|P AO SH
pô|P OW0
põe|P Y
público|P UW V L IY K UW
púcaro|P UW K AA R UW
púlpito|P UW L P IY T UW
pústula|P UW SH T UW L AA
q|K EH0
quadrado|K W AA DH R AE DH UW
quadro|K W AE DH R UW
qualidade|K W AA L IY DH AE DH IH0
quando|K W AA D UW
quanta|K W AA T AA
quantia|K W AA T IY AA
quantidade|K W AA T IY DH AE DH IH0
quanto|K W AA T UW
quantum|K W AA T
quaresma|K W AA R EH ZH M AA
quartinho|K W AE R T IY N IY0 UW
quatro|K W AE T R UW
quebra|K EH B R AA
quebradeira|K IH0 V R AA DH AA Y R AA
quebradiço|K IH0 V R AA DH IY S UW
quebrado|K IH0 V R AE DH UW
quebrar|K IH0 V R AE R
queca|K EH K AA
queda|K EH DH AA
queimadura|K AA Y M AA DH UW R AA
queirós|K AA Y R AO SH
queixa|K AA Y SH AA
queixume|K AA Y SH UW M
quelimane|K EH0 L IY M AE N IY
quelónio|K IH0 L AO N Y UW
quem|K AA Y
quera|K W EH R AE
quero|K EH R UW
questionar|K IH0 SH T Y UW N AE R
questão|K IH0 SH T AA W
quieto|K EH T UW
quilha|K IY L IY AA
quilo|K IY L UW
quimbundo|K B D UW
quimera|K IY M EH R AA
quimérico|K IY M EH R IY K UW
quinhão|K IY N IY0 AA W
quinta|K T AA
quinto|K T UW
quiosque|K Y AO SH K IH0
quiprocó|K IY P R OW0 K AO
quiproquó|K W IY P R OW0 K W AO
quipá|K IY P AE
quisera|K IY Z EH R AA
quiseram|K IY Z EH R AA W
quisto|K IY S T UW
quite|K IY T IH0
quivi|K IY V IY
quizumba|K IY Z B AE
quiçá|K IY S AE
quota|K W AO T AA
quão|K W AA W
quê|K EH0
química|K IY M IY K AA
químico|K IY M IY K UW
quórum|K W AO R
qüiproquó|K W IY P R OW0 K W AO
rabicho|RH AE B IY SH UW
rabino|RH AA V IY N UW
rabo|RH AE B UW
racial|RH AA S Y AE L
raciocínio|RH AA S Y UW S IY N Y UW
racional|RH AA S Y UW N AE L
raiar|RH AE Y AE R
ralé|RH AA L EH
ramagem|RH AA M AE ZH AA Y
ramagens|RH AA M AE ZH AA Y SH
ramificação|RH AA M IY F IY K AA S AA W
ramo|RH AA M UW
ramos|RH AA M UW SH
rampa|RH AA P AA
rancor|RH AA K OW0 R
rangir|RH AA ZH IY R
rapar|RH AA P AE R
rapaziada|RH AA P AA Z Y AE DH AA
rapto|RH AE P T UW
raspar|RH AA SH P AE R
rasuro|RH AE Z UW R UW
razões|RH AA Z Y SH
raça|RH AE S AA
ração|RH AA S AA W
reagir|RH IY AA ZH IY R
reais|RH IH0 AE Y SH
realidade|RH Y AA L IY DH AE DH IH0
realçar|RH Y AE L S AE R
reativação|RH IH0 AE T IY V AA S AA W
reator|RH Y AE T OW0 R
reação|RH Y AE S AA W
rebanho|RH IH0 V AA N IY0 UW
rebentar|RH IH0 V T AE R
rebobinar|RH IH0 V UW V IY N AE R
recado|RH IH0 K AE DH UW
recalcar|RH IH0 K AE L K AE R
recanto|RH IH0 K AA T UW
recato|RH IH0 K AE T UW
recear|RH IH0 S Y AE R
receber|RH IH0 S IH0 V EH0 R
recebera|RH IH0 S IH0 V EH0 R AA
receberá|RH IH0 S IH0 V IH0 R AE
recebido|RH IH0 S IH0 V IY DH UW
receio|RH IH0 S AA Y UW
receitar|RH IH0 S AA Y T AE R
receoso|RH IH0 S Y OW0 Z UW
recetor|RH IH0 S EH T OW0 R
recibo|RH IH0 S IY V UW
reciclar|RH IH0 S IY K L AE R
recinto|RH EH0 S N T UW
recipiente|RH IH0 S IY P Y T IH0
recitar|RH IH0 S IY T AE R
reclinou|RH EH0 K L IY N OW0 W
reco|RH EH K UW
recombinação|RH IH0 K B IY N AA S AA W
recompensa|RH IH0 K P S AA
reconhecer|RH IH0 K UW N IY0 IH0 S EH0 R
recordação|RH IH0 K UW R DH AA S AA W
recostou|RH EH0 K OW0 S T OW0 W
recusar|RH IH0 K UW Z AE R
redação|RH IH0 DH AE S AA W
redenção|RH IH0 DH S AA W
redobrar|RH IH0 DH UW V R AE R
redondo|RH IH0 DH D UW
redor|RH IH0 DH AO R
redundância|RH IH0 DH D AA S Y AA
refeição|RH IH0 F AA Y S AA W
refizesse|RH EH0 F IY Z EH0 S IY
reflexo|RH IH0 F L EH K S UW
reflexão|RH IH0 F L EH S AA W
reforma|RH IH0 F AO R M AA
reformista|RH IH0 F AO R M IY SH T AA
reforçar|RH IH0 F UW R S AE R
reforço|RH IH0 F OW0 R S UW
refrescar|RH IH0 F R IH0 SH K AE R
refresco|RH IH0 F R EH0 SH K UW
regalo|RH IH0 HH AE L UW
regata|RH IH0 G AE T AA
regime|RH IH0 ZH IY M IH0
registar|RH IH0 ZH IY SH T AE R
regra|RH EH HH R AA
regressar|RH IH0 HH R IH0 S AE R
regresso|RH IH0 HH R EH S UW
regulamento|RH IH0 HH UW L AA M T UW
regular|RH IH0 HH UW L AE R
regularidade|RH IH0 HH UW L AA R IY DH AE DH IH0
regímen|RH IH0 ZH IY M EH N
reis|RH AA Y SH
rejuvenescer|RH IH0 ZH UW V IH0 N IH0 SH S EH0 R
relacionado|RH IH0 L AA S Y UW N AE DH UW
relacionamento|RH IH0 L AA S Y UW N AA M T UW
relacionar|RH IH0 L AA S Y UW N AE R
relance|RH IH0 L AA S IH0
relatar|RH IH0 L AA T AE R
relativamente|RH IH0 L AA T IY V AA M T IH0
relato|RH IH0 L AE T UW
relação|RH IH0 L AA S AA W
relações|RH IH0 L AA S Y SH
relicário|RH IH0 L IY K AE R Y UW
religiosidade|RH IH0 L IY ZH Y UW Z IY DH AE DH IH0
religioso|RH IH0 L IY ZH Y OW0 Z UW
religião|RH IH0 L IY ZH Y AA W
relojoeiro|RH IH0 L UW ZH W AA Y R UW
relva|RH EH L V AA
relíquia|RH IH0 L IY K Y AA
relógio|RH IH0 L AO ZH Y UW
remanejamento|RH EH0 M AE N EH0 ZH AE M T UW
remanejar|RH EH0 M AE N EH0 ZH AE R
remela|RH IH0 M EH L AA
remendo|RH IH0 M D UW
remete|RH EH0 M EH T SH IY
remo|RH EH M UW
remoer|RH IH0 M W EH0 R
remoinho|RH IH0 M W IY N IY0 UW
remorso|RH IH0 M AO R S UW
remoto|RH IH0 M AO T UW
remover|RH IH0 M UW V EH0 R
remédio|RH IH0 M EH DH Y UW
renan|RH IH0 N AA N
renato|RH EH0 N AE T UW
rendas|RH D AA SH
rendição|RH D IY S AA W
renegado|RH IH0 N IH0 HH AE DH UW
renunciar|RH IH0 N S IY AE R
reparar|RH IH0 P AA R AE R
reparação|RH IH0 P AA R AA S AA W
repartir|RH IH0 P AA R T IY R
repartição|RH IH0 P AA R T IY S AA W
repetir|RH IH0 P IH0 T IY R
reportagem|RH IH0 P UW R T AE ZH AA Y
reportar|RH IH0 P UW R T AE R
repouso|RH IH0 P OW0 W Z UW
represa|RH IH0 P R EH Z AA
representando|RH IH0 P R IH0 Z T AA D UW
representar|RH IH0 P R IH0 Z T AE R
representativo|RH IH0 P R IH0 Z T AA T IY V UW
representação|RH IH0 P R IH0 Z T AA S AA W
reprise|RRR EH0 P RRR IY Z IY
reproduzir|RH IH0 P R UW DH UW Z IY R
reprodução|RH IH0 P R UW DH UW S AA W
repórter|RH IH0 P AO R T EH R
república|RH EH P UW V L IY K AA
requeijão|RH IH0 K AA Y ZH AA W
requinte|RH IH0 K T IH0
resende|RH EH Z D IH0
reserva|RH IH0 Z EH R V AA
reservar|RH IH0 Z IH0 R V AE R
resetar|RRR EH0 Z EH0 T AE R
resete|RH EH0 Z EH T SH IY
residente|RH IH0 Z IY D T IH0
residência|RH IH0 Z IY DH S Y AA
resignar|RH IH0 Z IY HH N AE R
resignação|RH IH0 Z IY G N AA S AA W
resina|RH IH0 Z IY N AA
resistir|RH IY Z IY SH T IY R
resistência|RH IH0 Z IY SH T S Y AA
resolução|RH IH0 Z UW L UW S AA W
resolver|RH IH0 Z OW0 L V EH0 R
respeitar|RH IH0 SH P AA Y T AE R
respeitosamente|RH IH0 SH P AA Y T AO Z AA M T IH0
respeitável|RH IH0 SH P AA Y T AE V EH L
respirar|RH IH0 SH P IY R AE R
respiração|RH IH0 SH P IY R AA S AA W
resplandecente|RH IH0 SH P L AA D IH0 S T IH0
responder|RH IH0 SH P D EH0 R
respondeu|RH IH0 SH P D EH0 W
responsabilidade|RH IH0 SH P S AA V L IY DH AE DH IH0
responsável|RH IH0 SH P S AE V EH L
resposta|RH IH0 SH P AO SH T AA
ressarcimento|RH EH0 S S AE R S IY M T UW
ressignificar|RH EH0 S IY G N IY F IY K AE R
resto|RH EH SH T UW
resultado|RH IH0 Z UW L T AE DH UW
resultante|RH IH0 Z UW L T AA T IH0
resumir|RH IH0 Z UW M IY R
resumo|RH IH0 Z UW M UW
retalho|RH IH0 T AE L IY UW
retardar|RH IH0 T AA R DH AE R
retirar|RH IH0 T IY R AE R
retornado|RH IH0 T UW R N AE DH UW
retrasado|RH EH0 T R AE Z AE D UW
retrospectivo|RH EH T R AO SH P EH T IY V UW
retrógrado|RH IH0 T R AO HH R AA DH UW
reunir|RH Y UW N IY R
reunião|RH Y UW N Y AA W
revelar|RH IH0 V IH0 L AE R
revelação|RH IH0 V IH0 L AA S AA W
reverência|RH IH0 V IH0 R S Y AA
revestir|RH IH0 V IH0 SH T IY R
revezar|RH EH0 V EH0 Z AE R
revista|RH IH0 V IY SH T AA
revisão|RH IH0 V IY Z AA W
revolto|RH IH0 V OW0 L T UW
revolução|RH IH0 V UW L UW S AA W
revés|RH IH0 V EH SH
revólver|RH IH0 V AO L V IH0 R
rezar|RH IH0 Z AE R
ria|RH IY AA
ribatejo|RH IY V AA T EH ZH UW
ribeira|RH IY V AA Y R AA
ribeiro|RH IY B AA Y R UW
rica|RH IY K AA
rifa|RH IY F AA
rigidamente|RH IY ZH IY DH AA M T IH0
rijo|RH IY ZH UW
rilhar|RH IY L IY AE R
rindo|RH D UW
ripostou|RH IY P OW0 S T OW0 W
riqueza|RH IY K EH0 Z AA
risco|RH IY SH K UW
riso|RH IY Z UW
risonho|RH IY Z OW0 N IY0 UW
ritmo|RH IY T M UW
rito|RH IY T UW
ritual|RH IY T W AE L
rivalidade|RH IY V AA L IY DH AE DH IH0
riável|R IY AE V EH L
roaz|RH UW AE SH
roca|RH AO K AA
rocha|RH AO SH AA
rock|RH AO K
roda|RH AO DH AA
rodapé|RH AO D AA P EH
rodar|RH UW D AE R
rodas|RH AO DH AA SH
rodeado|RH UW DH Y AE DH UW
rodo|RH AO DH UW
rodrigues|RH UW D R IY G IH0 SH
rojão|RH OW0 ZH AA W
rola|RH AO L AE
rolha|RH OW0 L IY AA
rom|RH AO M
romaji|RH AO M AE ZH IY
romance|RH UW M AA S IH0
romano|RH UW M AA N UW
rompeu|RH P EH0 W
romântico|RH UW M AA T IY K UW
ronco|RH K UW
ronda|RH D AA
ronrom|RH RH
ronrono|RH RH OW0 N UW
ronrons|RH RH S
rosado|RH UW Z AE DH UW
rosca|RH OW0 S K AA
roseira|RH UW Z AA Y R AA
rosácea|RH UW Z AE S Y AA
rotura|RH UW T UW R AA
roubar|RH OW0 W V AE R
roubo|RH OW0 W V UW
rouco|RH OW0 W K UW
roupas|RH OW0 W P AA SH
rovaniemi|RH UW V AA N Y EH M IY
roça|RH AO S AA
roçar|RH UW S AE R
rubi|RH UW B IY
ruga|RH UW HH AA
rugir|RH UW ZH IY R
rulote|RH UW L AO T IH0
rumo|RH UW M UW
runa|RH UW N AA
rutilo|RH UW T IY L AA
rápido|RH AE P IY DH UW
réptil|RH EH P T IY L
rígido|RH IY ZH IY DH UW
rítmico|RH IY T M IY K UW
rótula|RH AO T UW L AA
rúgbi|R UW G B IY
sabedoria|S AA V IH0 DH UW R IY AA
sabonete|S AA V UW N EH0 T IH0
sabor|S AA B OW0 R
saborear|S AA B UW R Y AE R
saboroso|S AA V UW R OW0 Z UW
sabrosa|S AA V R AO Z AA
sabugo|S AA B UW G UW
sabão|S AA V AA W
saca|S AE K AA
sacarídeo|S AA K AA R IY D Y UW
sacerdote|S AA S IH0 R D AO T IH0
sacerdócio|S AA S IH0 R DH AO S Y UW
sacho|S AE SH UW
saco|S AE K UW
sacola|S AA K AO L AA
sacra|S AE K R AA
sacramento|S AA K R AA M T UW
sacrifício|S AA K R IY F IY S Y UW
sacristia|S AE K R IY SH T IY AA
sacro|S AE K R UW
sacrossanto|S AE K R UW S AA T UW
sacrário|S AA K R AE R Y UW
safa|S AE F AA
safar|S AA F AE R
safra|S AE F R AA
sagrado|S AA HH R AE DH UW
sagrar|S AA HH R AE R
saguão|S AE G W AA W
sai|S AE Y
saia|S AE Y AA
saias|S AE Y AA SH
saibro|S AE Y V R UW
saindo|S AA D UW
saio|S AE Y UW
saiote|S AE Y AO T SH IY
sala|S AE L AA
salamaleque|S AA L AA M AA L EH K IH0
salazar|S AA L AA Z AE R
saleta|S AA L EH0 T AA
saliva|S AE L IY V AE
salário|S AA L AE R Y UW
salão|S AA L AA W
samba|S AA B AA
sambo|S AA B UW
samo|S AE M UW
sanar|S AA N AE R
sanatório|S AA N AA T AO R Y UW
sandeu|S AA D EH0 W
sandra|S AA D R AA
sandália|S AA D AE L Y AA
sandálias|S AA D AE L Y AA SH
saneamento|S AA N Y AA M T UW
sanfona|S AA F OW0 N AA
sangramento|S AA G R AA M T UW
sangrar|S AA G R AE R
sangrenta|S AA G R T AA
sangrento|S AA G R T UW
sangria|S AA G R IY AA
sangue|S AA G IH0
sanguenta|S AA G W T AA
sanguento|S AA G W T UW
sanguessuga|S AA G IH0 S UW HH AA
sansão|S AA S AA W
santa|S AA T AA
santidade|S AA T IY DH AE DH IH0
santo|S AA T UW
santos|S AA T UW SH
santuário|S AA T UW AE R Y UW
sanção|S AA S AA W
sapateado|S AA P AA T Y AE DH UW
sapato|S AA P AE T UW
sapatos|S AA P AE T UW SH
sapo|S AE P UW
sarado|S AE R AE D UW
saragoça|S AA R AA HH AO S AA
saraiva|S AA R AE Y V AA
saraivar|S AA R AE Y V AE R
sarcasmo|S AA R K AE ZH M UW
sargaço|S AA R HH AE S UW
sargento|S AA R ZH T UW
sarilho|S AA R IY L IY UW
sarrabulho|S AA RH AA V UW L IY UW
sarça|S AE R S AA
satisfazer|S AA T IY SH F AA Z EH0 R
satisfação|S AA T IY SH F AA S AA W
satisfeito|S AA T IY SH F AA Y T UW
saturar|S AA T UW R AE R
satélite|S AA T EH L IY T IH0
saudar|S AA UW DH AE R
saudação|S AE W D AA S AA W
saudável|S AE W D AE V EH L
sauna|S AE W N AA
saxão|S AE K S AA W
saído|S AA IY DH UW
seara|S Y AE R AA
sebastianismo|S IH0 V AA SH T Y AA N IY ZH M UW
sebo|S EH0 V UW
seca|S EH K AA
secar|S IH0 K AE R
seco|S EH K UW
secretaria|S IH0 K R IH0 T AA R IY AA
secrete|S EH0 K R EH T SH IY
secreto|S IH0 K R EH T UW
secretária|S IH0 K R IH0 T AE R Y AA
secretário|S IH0 K R IH0 T AE R Y UW
seda|S EH0 D AA
sedoso|S IH0 DH OW0 Z UW
sefardi|S IH0 F AA R DH IY
sefardim|S IH0 F AA R DH
sefardita|S IH0 F AA R DH IY T AA
segar|S IH0 HH AE R
segmento|S EH0 G M T UW
segredo|S IH0 HH R EH0 DH UW
segregação|S IH0 HH R IH0 HH AA S AA W
segue|S EH HH IH0
seguidor|S IH0 HH IY DH OW0 R
seguinte|S IH0 HH T IH0
seguir|S IH0 G IY R
seguira|S IH0 HH IY R AA
seguirá|S IH0 HH IY R AE
segurança|S IH0 HH UW R AA S AA
segurar|S IH0 HH UW R AE R
seguridade|S IH0 HH UW R IY DH AE DH IH0
seira|S AA Y R AA
seje|S EH0 ZH IY
sela|S EH L AA
selenita|S IH0 L IH0 N IY T AA
selo|S EH L UW
selva|S EH L V AA
selvagem|S EH L V AE ZH AA Y
semeador|S IH0 M Y AA DH OW0 R
semeadura|S IH0 M Y AA DH UW R AA
semear|S IH0 M Y AE R
semelhar|S IH0 M IH0 L IY AE R
semente|S IH0 M T IH0
sementeira|S IH0 M T AA Y R AA
semestre|S IH0 M EH SH T R IH0
semideus|S IH0 M IY DH EH0 W SH
semiólogo|S EH0 M Y AO L OW0 G UW
sempiterno|S P IY T EH R N UW
semáforos|S EH0 M AE F OW0 R UW S
senador|S IH0 N AE DH OW0 R
senciente|S S Y T IH0
senda|S D AA
sendo|S D UW
senectude|S IH0 N EH K T UW DH IH0
senhoras|S IH0 N IY0 OW0 R AA SH
senhores|S IH0 N IY0 OW0 R IH0 SH
senhoria|S IH0 N IY0 UW R IY AA
senhorio|S IH0 N IY0 UW R IY UW
seno|S EH0 N UW
senra|S RH AA
sensato|S S AE T UW
sensação|S S AA S AA W
sensibilidade|S S IY V IY L IY DH AE DH IH0
senso|S S UW
sensível|S S IY V EH L
senta|S T AA
sentada|S T AE DH AA
sentado|S T AE DH UW
sentar|S T AE R
sentença|S T S AA
sentia|S T IY AA
sentido|S T IY DH UW
sentimento|S T IY M T UW
sentindo|S T D UW
sentinela|S T IY N EH L AA
sentir|S T IY R
sentiu|S T IY W
sento|S T UW
sentou|S T OW0 W
separar|S IH0 P AA R AE R
separação|S IH0 P AA R AA S AA W
sepultar|S IH0 P UW L T AE R
sepultura|S IH0 P UW L T UW R AA
sequestro|S IH0 K EH SH T R UW
seriamente|S EH R Y AA M T IH0
sernancelhe|S IH0 R N AA S AA L IY IH0
serpente|S IH0 R P T IH0
sertã|S IH0 R T AA
servidor|S IH0 R V IY DH OW0 R
servidão|S IH0 R V IY DH AA W
servir|S IH0 R V IY R
serviço|S IH0 R V IY S UW
servo|S EH R V UW
sesimbra|S IH0 Z B R AA
sesta|S EH SH T AA
seta|S EH T AA
setim|S EH0 T SH
setor|S IH0 T OW0 R
seu|S EH0 W
severas|S IH0 V EH R AA SH
severidade|S IH0 V IH0 R IY DH AE DH IH0
severo|S IH0 V EH R UW
sexo|S EH K S UW
sexy|S EH K S IY
shiva|SH IY V AA
shizuko|SH IY Z UW K UW
si|S IY
sicofanta|S IY K OW0 F AA T AA
sidra|S IY DH R AA
sigilo|S IY ZH IY L UW
significado|S IY G N IY F IY K AE DH UW
significativo|S IY HH N IY F IY K AA T IY V UW
silenciosa|S IY L S Y AO Z AA
silencioso|S IY L S Y OW0 Z UW
silhueta|S IY L IY W EH0 T AA
silva|S IY L V AA
silvestre|S IY L V EH SH T R IH0
silêncio|S IY L S Y UW
sim|S
simbolizando|S B UW L IY Z AA D UW
simbolizar|S B UW L IY Z AE R
simbologia|S B OW0 L OW0 ZH IY AE
similar|S IH0 M IY L AE R
simpatizante|S P AE T IY Z AA T IH0
simples|S P L IH0 SH
simplesmente|S P L IH0 ZH M T IH0
simplicidade|S P L IY S IY DH AE DH IH0
simplificar|S P L IY F IY K AE R
simpático|S P AE T IY K UW
simulacro|S IY M UW L AE K R UW
simum|S IY M
sina|S IY N AA
sinais|S IY N AE Y SH
sinalizar|S IY N AA L IY Z AE R
sinalização|S IY N AA L IY Z AA S AA W
sinceramente|S S EH R AA M T IH0
sinceridade|S S IH0 R IY DH AE DH IH0
sincero|S S EH R UW
sindicato|S D IY K AE T UW
sineiro|S IY N AA Y R UW
sineta|S IY N EH0 T AA
sinfonia|S F UW N IY AA
sinfonista|S F UW N IY SH T AA
singrar|S G R AE R
sinistro|S IY N IY SH T R UW
sinquisita|S K IY Z IY T AA
sintaxe|S T AE S IY
sinto|S T UW
sintoma|S T OW0 M AA
sintonia|S T UW N IY AA
sintra|S T R AA
sinó|S IY N AO
sirgo|S IY R HH UW
siririca|S IY R IY R IY K AE
siso|S IY Z UW
sistema|S IY SH T EH0 M AA
sistematizar|S IY SH T IH0 M AA T IY Z AE R
situação|S IY T W AA S AA W
soalheiro|S W AA L IY AA Y R UW
soalho|S W AE L IY UW
sob|S OW0 B
sobe|S AO V IH0
sobejo|S UW V AA Y ZH UW
soberania|S UW V IH0 R AA N IY AA
sobra|S AO V R AA
sobrar|S UW V R AE R
sobre|S AO B R IH0
sobreiro|S UW B R EH0 Y R UW
sobretudo|S OW0 V R IH0 T UW DH UW
sobreviver|S OW0 V R IH0 V IY V EH0 R
sobrinha|S UW V R IY N IY0 AA
sobrinho|S UW V R IY N IY0 UW
sociabilidade|S OW0 S Y AE B IY L IY D AE D ZH IY
sociabilizar|S UW S Y AA B IY L IY Z AE RRR
socialismo|S UW S Y AE L IY ZH M UW
socializar|S UW S Y AA L IY Z AE R
sociedade|S UW S Y AA DH AE DH IH0
sociocultural|S AO S Y AO K UW L T UW R AE L
soclo|S AO K L UW
soer|S W EH0 R
sofreguidão|S OW0 F R IH0 HH IY DH AA W
sofrer|S UW F R EH0 R
sofrimento|S UW F R IY M T UW
sofá|S UW F AE
soito|S OW0 Y T UW
solado|S UW L AE D UW
soldado|S AO L D AE DH UW
soleira|S UW L AA Y R AA
solidez|S UW L IY DH EH0 SH
solidificar|S UW L IY DH IY F IY K AE R
solidificação|S UW L IY DH IY F IY K AA S AA W
solidão|S UW L IY DH AA W
solidéu|S AO L IY DH EH W
solitário|S UW L IY T AE R Y UW
solo|S AO L UW
sologamia|S AO L OW0 G AA M IY AE
soltar|S OW0 L T AE R
solteiro|S UW L T AA Y R UW
solto|S OW0 L T UW
solucionar|S UW L UW S Y UW N AE R
soluçar|S UW L UW S AE R
soluço|S UW L UW S UW
solução|S UW L UW S AA W
solão|S AO L AA W
som|S
soma|S AO M AA
sombra|S B R AA
sombras|S B R AA SH
sombreiro|S B R AA Y R UW
sombrio|S B R IY W
sonda|S D AA
soneto|S UW N EH0 T UW
sonhador|S UW N IY0 AA DH OW0 R
sonhar|S UW N IY0 AE R
sonho|S OW0 N IY0 UW
sonhos|S OW0 N IY0 UW SH
sonolento|S UW N UW L T UW
soo|S OW0 UW
sopa|S OW0 P AA
sopesar|S OW0 P EH0 Z AE RH
soprar|S UW P R AE R
sopro|S AO P R UW
sopé|S OW0 P EH
soquete|S AO K EH T IH0
soro|S AO R UW
soror|S UW RRR AO RRR
sorria|S UW RH IY AA
sorridente|S UW RH IY DH T IH0
sorrindo|S UW RH D UW
sorrir|S UW RH IY R
sorriso|S UW RH IY Z UW
sorriu|S UW RH IY W
sorte|S AO R T IH0
sorteio|S UW RRR T AA Y UW
sorumbático|S UW R B AE T IY K UW
sossegado|S UW S IH0 G AE D UW
sossegar|S UW S IH0 HH AE R
sossego|S UW S EH HH UW
sotaina|S OW0 T AE Y N AE
sou|S OW0 W
sousa|S OW0 W Z AA
sousel|S OW0 W Z EH L
souto|S OW0 W T UW
sua|S UW AA
suavidade|S W AA V IY DH AE DH IH0
suaíli|S W AE IY L IY
suba|S UW V AA
subclínico|S UW B K L IY N IY K UW
subdivisão|S UW V IH0 DH IH0 V IY Z AA W
subindo|S UW V D UW
subir|S UW V IY R
subitamente|S UW V IY T AA M T IH0
subiu|S UW V IY W
subjetivamente|S UW B ZH EH T IY V AA M T IH0
subjetivo|S UW B ZH EH T IY V UW
sublevação|S UW V L IH0 V AA S AA W
sublimar|S UW V L IY M AE R
sublimação|S UW V L IY M AA S AA W
sublime|S UW B L IY M IH0
submete|S UW B M EH T SH IY
subsistir|S UW B Z IY SH T IY R
substancial|S UW B SH T AA S Y AE L
substantivar|S UW B SH T AA T IY V AE RRR
substantivo|S UW B SH T AA T IY V UW
substância|S UW B SH T AA S Y AA
subterfúgio|S UW B T EH0 RRR F UW ZH Y UW
subversivo|S UW V IH0 V IH0 R S IY V UW
subversão|S UW V IH0 V IH0 R S AA W
subúrbio|S UW V UW R V Y UW
suceder|S UW S IH0 DH EH0 R
sucedido|S UW S IH0 DH IY DH UW
sucessivo|S UW S IH0 S IY V UW
sucesso|S UW S EH S UW
sucessão|S UW S IH0 S AA W
sucinto|S UW S T UW
suco|S UW K UW
suculento|S UW K UW L T UW
sucumbir|S UW K B IY R
sudeste|S UW DH EH SH T IH0
sudoeste|S UW DH W EH SH T IH0
suficiente|S UW F IH0 S Y T IH0
suflê|S UW F L EH0
sufocado|S UW F UW K AE DH UW
sufocar|S UW F UW K AE R
sugerir|S UW ZH IH0 R IY R
sugestivo|S UW ZH IH0 SH T IY V UW
sugestão|S UW ZH IH0 SH T AA W
sujar|S UW ZH AE R
sujeito|S UW ZH AA Y T UW
sujeitos|S UW ZH AA Y T UW SH
sujo|S UW ZH UW
sulfossal|S UW L F UW S AE L
sumiko|S UW M IY K UW
suo|S UW UW
suor|S UW AO R
superavitário|S UW P EH0 RRR AE V IY T AE RRR Y UW
superfície|S UW P IH0 R F IY S Y IH0
superior|S UW P IH0 R Y OW0 R
superioridade|S UW P IH0 R Y UW R IY DH AE DH IH0
supermercado|S UW P EH R M IH0 R K AE D UW
supersticioso|S UW P IH0 R SH T IY S Y OW0 Z UW
superstição|S UW P IH0 R SH T IY S AA W
superveniência|S UW P EH0 R V EH0 N IY S Y AE
supervisor|S UW P EH R V IY Z OW0 R
superácido|S UW P EH R AE S IY D UW
suportar|S UW P UW R T AE R
suporte|S UW P AO R T IH0
suportável|S UW P UW R T AE V EH L
suposição|S UW P UW Z IY S AA W
supostamente|S UW P OW0 SH T AA M T IH0
supremacia|S UW P R IH0 M AA S IY AA
supremo|S UW P R EH0 M UW
suprir|S UW P R IY R
surdo|S UW R DH UW
surfar|S AA R F AE R
suricato|S UW R IY K AE T UW
surpreender|S UW R P R Y D EH0 R
surpreendido|S UW R P R Y D IY DH UW
surpresa|S UW R P R EH0 Z AA
surpreso|S UW R P R EH0 Z UW
surrão|S UW RH AA W
susana|S UW Z AA N AA
suspeita|S UW SH P AA Y T AA
suspenso|S UW SH P S UW
suspirar|S UW SH P IY R AE R
suspiro|S UW SH P IY R UW
sussurro|S UW S UW RH UW
sustentar|S UW SH T T AE R
sustentação|S UW SH T T AA S AA W
sustento|S UW SH T T UW
sustentável|S UW SH T T AE V EH L
suster|S UW SH T EH0 R
suzuki|S UW Z UW K IY
sátão|S AE T AA W
sã|S AA
são|S AA W
sé|S EH
séculos|S EH K UW L UW SH
sémita|S EH M IY T AA
sê|S EH0
sêmea|S EH0 M Y AA
síntese|S T IH0 Z IH0
sísifo|S IY Z IY F UW
sítio|S IY T Y UW
só|S AO
sóbrio|S AO B R Y UW
sódio|S AO D Y UW
sóror|S AO RRR AO RRR
sósia|S AO Z Y AA
sótão|S AO T AA W
sôfrego|S OW0 F R IH0 HH UW
súplica|S UW P L IY K AA
ta|T AA
tabaco|T AA V AE K UW
tabela|T AA V EH L AA
taberna|T AA V EH R N AA
tabuada|T AA V W AE DH AA
tabuaço|T AA V UW AE S UW
tabular|T AA B UW L AE R
tacha|T AE SH AA
tachar|T AA SH AE R
tacho|T AE SH UW
taciturno|T AA S IY T UW R N UW
taco|T AE K UW
tael|T AA EH L
tala|T AE L AA
talento|T AA L T UW
talha|T AE L IY AA
talhar|T AA L IY AE R
talhe|T AE L IY IY
talher|T AE L IY EH RH
talho|T AE L IY UW
talo|T AE L UW
tamanho|T AA M AA N IY0 UW
tambor|T AA B OW0 R
tamborilar|T AA B OW0 RRR IY L AE R
tamos|T AA M UW S
tampouco|T AA W P OW0 W K UW
tanga|T AA G AA
tangente|T AA ZH T IH0
tangerina|T AA ZH IH0 R IY N AA
tango|T AA G UW
tanja|T AA ZH AA
tanque|T AA K IH0
tansa|T AA S AA
tanso|T AA S UW
tanta|T AA T AA
tanto|T AA T UW
tantos|T AA T UW SH
tapa|T AE P AA
tapete|T AA P EH0 T IH0
tapeçaria|T AA P IH0 S AA R IY AA
tar|T AE R
tardezinha|T AE R D IH0 Z IY N IY0 AA
tardio|T AA R DH IY UW
tareco|T AE RRR EH K UW
tarefa|T AA R EH F AA
tarouca|T AA R OW0 W K AA
tarrafa|T AE RH AE F AE
tarraxa|T AA RH AE SH AA
tarraxar|T AA RH AA SH AE R
tarô|T AE R OW0
tasca|T AE SH K AA
tatiana|T AA T Y AA N AA
tato|T AE T UW
tatu|T AE T UW
tau|T AE W
tava|T AE V AA
tavam|T AE V AA W
taverna|T AA V EH R N AA
taxa|T AE SH AA
taxar|T AA SH AE R
taxo|T AE SH UW
taça|T AE S AA
taís|T AE IY S
taísa|T AE IY Z AA
taíse|T AE IY Z IY
te|T IH0
tear|T Y AE RRR
tecer|T IH0 S EH0 R
tecla|T EH K L AA
teclado|T EH K L AE DH UW
teco|T EH K UW
teias|T AA Y AA SH
teima|T AA Y M AA
teimar|T AA Y M AE R
teixeira|T AA Y SH AA Y R AA
teja|T EH0 ZH AA
teje|T EH0 ZH IY
tela|T EH L AA
telecomando|T EH L EH K UW M AA D UW
teledramaturgia|T EH L EH0 D R AE M AE T UW RH ZH IY AE
telemóvel|T EH L EH M AO V EH L
telhado|T IH0 L IY AE DH UW
telhar|T IH0 L IY AE R
temer|T IH0 M EH0 R
tempera|T P EH R AA
temperamento|T P IH0 R AA M T UW
temperatura|T P IH0 R AA T UW R AA
tempero|T P EH R UW
templo|T P L UW
tempo|T P UW
temporão|T P OW0 R AA W
tempurá|T P UW R AE
tempão|T P AA W
tenda|T D AA
tender|T D EH0 R
tendo|T D UW
tendência|T D S Y AA
tenebroso|T IH0 N IH0 V R OW0 Z UW
tenso|T S UW
tensão|T S AA W
tenta|T T AA
tentar|T T AE R
tentativa|T T AA T IY V AA
tentação|T T AA S AA W
tento|T T UW
tença|T S AE
tenção|T S AA W
tenência|T EH0 N S Y AE
teoria|T Y UW R IY AA
tera|T EH R AA
tergiversar|T EH0 R ZH IY V EH0 R S AE RRR
tergiversação|T EH0 R ZH IY V EH0 R S AE S AA W
terminar|T IH0 R M IY N AE R
terminou|T IH0 R M IY N OW0 W
termo|T EH0 R M UW
ternamente|T EH R N AA M T IH0
ternura|T IH0 R N UW R AA
terrinha|T EH RH IY N IY0 AA
territorial|T IH0 RH IY T UW R Y AE L
território|T IH0 RH IY T AO R Y UW
terrivelmente|T IH0 RH IY V EH L M T IH0
terráqueo|T IH0 RH AE K Y UW
terrível|T IH0 RH IY V EH L
tese|T EH Z IH0
tesouro|T IH0 Z OW0 W R UW
testamento|T IH0 SH T AA M T UW
testar|T IH0 SH T AE R
teste|T EH SH T IH0
testemunha|T IH0 SH T IH0 M UW N IY0 AA
testemunhar|T IH0 SH T IH0 M UW N IY0 AE R
testemunho|T IH0 SH T IH0 M UW N IY0 UW
teta|T EH T AA
teto|T EH T UW
teu|T EH0 W
tez|T EH0 SH
teórico|T Y AO R IY K UW
thaísa|T AE IY Z AA
tigela|T IY ZH EH L AA
tijolo|T IY ZH OW0 L UW
timidez|T IY M IY DH EH0 SH
tingitano|T ZH IY T AA N UW
tinhoso|T IY Y OW0 Z UW
tinir|T IY N IY R
tinteiro|T T AA Y R UW
tintim|T T
tinto|T T UW
tiranizar|T IY R AA N IY Z AE R
tirano|T IY R AA N UW
tiro|T IY R UW
tiros|T IY R UW SH
tição|T IY S AA W
toca|T AO K AA
tocando|T UW K AA D UW
tocara|T UW K AE R AA
tocará|T UW K AA R AE
tocava|T UW K AE V AA
tocha|T AO SH AA
tocou|T UW K OW0 W
toirada|T OW0 Y R AE DH AA
toiro|T OW0 Y R UW
tojo|T OW0 ZH UW
tolerar|T UW L IH0 R AE R
tolete|T UW L EH0 T IH0
tolice|T UW L IY S IH0
tolo|T OW0 L UW
tolosa|T UW L AO Z AA
tom|T
tomada|T UW M AE DH AA
tomado|T UW M AE DH UW
tomando|T UW M AA D UW
tomar|T UW M AE R
tomara|T UW M AE R AA
tomateiro|T UW M AA T AA Y R UW
tomava|T UW M AE V AA
tome|T AO M IH0
tomou|T UW M OW0 W
tondela|T D EH L AA
tonfa|T F AE
tonga|T G AA
tons|T SH
tonto|T T UW
tontura|T T UW R AA
tope|T AO P IH0
topo|T AO P UW
toque|T AO K IY
toranja|T UW R AA ZH AA
torneio|T UW RRR N AA Y UW
torneira|T UW R N AA Y R AA
tornozelo|T UW R N UW Z EH0 L UW
toro|T AO R UW
torpe|T AO R P IY
torrada|T UW RH AE DH AA
torrente|T UW RH T IH0
torres|T OW0 RH IH0 SH
torto|T OW0 RRR T OW0
tortura|T UW R T UW R AE
torturar|T UW R T UW R AE R
toscana|T UW SH K AA N AA
toscanas|T UW SH K AA N AA SH
toscano|T UW SH K AA N UW
toscanos|T UW SH K AA N UW SH
tosco|T OW0 SH K UW
toscânia|T UW SH K AA N Y AA
tosse|T AO S IH0
tostão|T UW SH T AA W
totais|T OW0 T AE Y SH
totalidade|T UW T AA L IY DH AE DH IH0
tourada|T OW0 W R AE DH AA
touro|T OW0 W R UW
trabalhador|T R AA V AA L IY AA DH OW0 R
trabalhoso|T R AA V AA L IY OW0 Z UW
trabuco|T R AE B UW K UW
tradutor|T R AA DH UW T OW0 R
trafalgar|T R AA F AE L G AE R
tragédia|T R AA ZH EH D Y AA
trai|T R AE Y
traidor|T R AE Y DH OW0 R
trajar|T R AA ZH AE R
traje|T R AE ZH IH0
trajo|T R AE ZH UW
tralha|T R AE L IY AA
trama|T R AA M AA
tramar|T R AA M AE R
tranca|T R AA K AA
trancar|T R AA K AE R
tranco|T R AA K UW
trancoso|T R AA K OW0 Z UW
tranquila|T R AA K W IY L AA
tranquilamente|T R AA K W IY L AA M T IH0
tranquilidade|T R AA K W IY L IY DH AE DH IH0
tranquilo|T R AA K W IY L UW
transa|T R AA Z AA
transação|T R AA Z AE S AA W
transfretano|T R AA SH F R IH0 T AA N UW
transitório|T R AA Z IY T AO R Y UW
transição|T R AA Z IY S AA W
transmitir|T R AA SH M IY T IY R
transparente|T R AA SH P AA R T IH0
transplantar|T R AA SH P L AA T AE R
transportar|T R AA SH P UW R T AE R
transporte|T R AA SH P AO R T IH0
trança|T R AA S AA
trançar|T R AA S AE R
tranço|T R AA S UW
trapaça|T R AA P AE S AA
trapo|T R AE P UW
trapézio|T R AA P EH Z Y UW
traquejo|T R AE K EH0 ZH UW
trata|T R AE T AA
tratado|T R AA T AE DH UW
tratamento|T R AA T AA M T UW
tratar|T R AA T AE R
tratava|T R AA T AE V AA
trato|T R AE T UW
trator|T R AE T OW0 R
trauma|T R AE W M AA
trava|T R AE V AA
travando|T R AA V AA D UW
travar|T R AA V AE R
traveco|T R AE V EH K UW
travessa|T R AA V EH S AA
travesseiro|T R AA V IH0 S AA Y R UW
travessia|T R AA V IH0 S IY AA
travou|T R AA V OW0 W
travão|T R AA V AA W
traça|T R AE S AA
traçar|T R AA S AE R
traço|T R AE S UW
traído|T R AA IY DH UW
trecho|T R EH0 SH UW
treco|T R EH K UW
treinamento|T R AA Y N AA M T UW
tremendo|T R IH0 M D UW
tremer|T R IH0 M EH0 R
tremia|T R IH0 M IY AA
tremoço|T R IH0 M OW0 S UW
tremura|T R EH0 M UW R AE
trena|T R EH0 N AA
treno|T R EH0 N UW
trenó|T R EH0 N AO
trepadeira|T R IH0 P AA DH AA Y R AA
treva|T R EH V AA
trevo|T R EH0 V UW
trevoso|T R IH0 V OW0 Z UW
tri|T R IY
tribo|T R IY B UW
tributo|T R IY V UW T UW
tricô|T R IY K OW0
trigésimo|T R IY ZH EH Z IY M UW
trilha|T R IY L IY AA
trilho|T R IY L IY UW
trinta|T R T AA
tripa|T R IY P AA
tripla|T R IY P L AA
trisavó|T R IY Z AA V AO
trisavô|T R IY Z AA V OW0
triscar|T R IY SH K AE R
triste|T R IY SH T IH0
tristes|T R IY SH T IH0 SH
tristeza|T R IY SH T EH0 Z AA
tristonha|T R IY SH T OW0 N IY0 AA
tristonho|T R IY SH T OW0 N IY0 UW
tritura|T R IY T UW R AE
triturado|T R IY T UW R AE DH UW
triturar|T R IY T UW R AE R
trituro|T R IY T UW R UW
tritão|T R IY T AA W
triunfante|T R IY F AA T IH0
trivialidade|T RRR IY V IY AE L IY D AE D ZH IY
triângulo|T R IY AA G UW L UW
troca|T R AO K AA
trocadilho|T R UW K AA DH IY L IY UW
trocador|T R UW K AA DH OW0 R
troco|T R AO K UW
trofa|T R AO F AA
trom|T R
tromba|T R B AA
trombeta|T R B EH0 T AA
trombone|T R B AO N IH0
tronco|T R K UW
troncos|T R K UW SH
tropa|T R AO P AA
tropelia|T R UW P IH0 L IY AA
trotineta|T RRR AO T IY N EH T AA
trotskismo|T R AO T S K IY ZH M UW
trouxa|T R OW0 W SH AA
trouxera|T R OW0 W S EH R AA
trouxeram|T R OW0 W S EH R AA W
trova|T RRR AO V AA
trovador|T R UW V AA DH OW0 R
trovar|T RRR UW V AE RRR
troço|T R AO S UW
trufa|T R UW F AA
trunfo|T R F UW
trágico|T RRR AE ZH IY K UW
trânsito|T R AA Z IY T UW
tríptico|T R IY P T IY K UW
tsunâmis|T S UW N AA M IY S
tu|T UW
tua|T UW AA
tucuxi|T UW K UW SH IY
tudo|T UW DH UW
tufo|T UW F UW
tufão|T UW F AA W
tui|T UW Y
tuiuiú|T UW Y UW Y UW
tulipa|T UW L IY P AA
tumor|T UW M OW0 R
tumulto|T UW M UW L T UW
tundra|T D R AA
tupi|T UW P IY
tupiniquim|T UW P IY N IY K
tupla|T UW P L AA
tupã|T UW P AA
turba|T UW R V AA
turbulento|T UW R V UW L T UW
turno|T UW R N UW
turra|T UW RH AA
turu|T UW R UW
tussa|T UW S AA
tutela|T UW T EH L AA
tutelar|T UW T IH0 L AE R
tá|T AE
tábua|T AE V W AA
tácito|T AE S IY T UW
tálus|T AE L UW S
táxi|T AE K S IY
tâmara|T AA M AA R AA
tântalo|T AA T AE L UW
tão|T AA W
técnico|T EH K N IY K UW
tédio|T EH DH Y UW
término|T EH R M IY N UW
térmita|T EH RRR M IY T AA
tétrico|T EH T R IY K UW
tê|T EH0
tíbia|T IY V Y AA
tímida|T IY M IY DH AA
tímido|T IY M IY DH UW
tísica|T IY Z IY K AA
tísico|T IY Z IY K UW
tó|T AO
tórax|T AO R AE K S
tóxico|T AO K S IY K UW
tô|T OW0
túlipa|T UW L IY P AA
túmulo|T UW M UW L UW
u|UW
uai|UW AE Y
uau|W AE W
ufa|UW F AA
ufólogo|UW F AO L UW HH UW
uhul|UW RH UW W
uivo|UW Y V UW
ulterior|UW L T IH0 R Y OW0 R
ultrapassar|UW L T R AA P AA S AE R
ultrassom|UW L T R AA S
ultrassónico|UW L T R AA S AO N IY K UW
um|
umas|UW M AA SH
umbigada|B IY G AE D AA
underline|AA D EH0 R L AE Y N IY
ungido|ZH IY DH UW
ungir|ZH IY R
unhar|UW N IY0 AE R
unhas|UW N IY0 AA SH
unicamente|UW N IY K AA M T IH0
unidade|UW N IY DH AE DH IH0
unido|UW N IY DH UW
unificar|UW N IY F IY K AE R
unificação|UW N IY F IY K AA S AA W
unilateralismo|UW N IY L AE T EH0 R AE L IY S M UW
unir|UW N IY R
universal|UW N IY V IH0 R S AE L
universidades|UW N IY V EH0 RRR S IY D AE D ZH IY S
universo|UW N IY V EH R S UW
união|UW N Y AA W
uns|SH
untar|T AE R
unto|T UW
unção|S AA W
uníssono|UW N IY S UW N UW
urbano|UW R V AA N UW
urdir|UW R DH IY R
ureia|UW RRR AA Y AA
uretra|UW R EH T R AA
urinar|UW R IY N AE R
urna|UW R N AA
uro|UW R UW
urrar|UW RH AE R
urro|UW RH UW
urubiciense|UW R UW B IY S IY S IY
urucum|UW R UW K
uruguaio|UW R UW G W AE Y UW
urupemense|UW R UW P EH0 M S IY
urutau|UW R UW T AE W
usa|UW Z AA
usam|UW Z AA W
usando|UW Z AA D UW
usara|UW Z AE R AA
usava|UW Z AE V AA
uso|UW Z UW
usou|UW Z OW0 W
usso|UW S UW
usufruto|UW Z UW F R UW T UW
usura|UW Z UW R AE
usurpação|UW Z UW R P AA S AA W
usuário|UW Z W AE R Y UW
utilização|UW T IY L IY Z AA S AA W
utópico|UW T AO P IY K UW
uva|UW V AA
ué|W EH
uísque|W IY SH K IH0
vaca|V AE K AA
vacante|V AA K AA T IH0
vadio|V AE DH IY UW
vadoso|V AA DH OW0 Z UW
vagabundagem|V AE G AE B D AE ZH Y
vagabundo|V AA HH AA V D UW
vagamente|V AE HH AA M T IH0
vagante|V AA HH AA T IH0
vagar|V AA HH AE R
vagarosamente|V AA HH AA R AO Z AA M T IH0
vagaroso|V AA HH AA R OW0 Z UW
vagos|V AE HH UW SH
vai|V AE Y
vaidoso|V AE Y DH OW0 Z UW
vala|V AE L AA
valentão|V AA L T AA W
vales|V AE L IH0 SH
valha|V AE L IY AA
valho|V AE L IY UW
validar|V AA L IY D AE R
valo|V AE L UW
valorizar|V AA L UW R IY Z AE R
vampiro|V AA P IY R UW
vandalizar|V AA D AA L IY Z AE R
vantajoso|V AA T AA ZH OW0 Z UW
vaqueiro|V AA K AA Y R UW
vara|V AE R AA
varandas|V AA R AA D AA SH
varapau|V AE R AE P AE W
variar|V AA R Y AE R
variedade|V AA R Y EH DH AE DH IH0
varonis|V AA R UW N IY SH
vaso|V AE Z UW
vasos|V AE Z UW SH
vassalo|V AA S AE L UW
vassoura|V AA S OW0 W R AA
vasta|V AE SH T AA
vastidão|V AA SH T IY DH AA W
vasto|V AE SH T UW
vatapá|V AE T AE P AE
vau|V AE W
vaza|V AE Z AA
vazamento|V AA Z AA M T UW
vazar|V AA Z AE R
vazias|V AA Z IY AA SH
vazio|V AA Z IY UW
vazo|V AE Z UW
veado|V Y AE D UW
vegete|V EH0 ZH EH T SH IY
veias|V AA Y AA SH
vela|V EH L AA
velar|V IH0 L AE R
velas|V EH L AA SH
veleiro|V IH0 L AA Y R UW
velejar|V IH0 L IH0 ZH AE R
velha|V EH L IY AA
velhaco|V IH0 L IY AE K UW
velhice|V IH0 L IY IY S IH0
velhinho|V EH L IY IY N IY0 UW
velhote|V EH L IY AO T IH0
velhão|V EH L IY AA W
velhíssimo|V IH0 L IY IY S IY M UW
velocidade|V IH0 L UW S IY DH AE DH IH0
veludo|V IH0 L UW DH UW
veludos|V IH0 L UW DH UW SH
vencelho|V S EH0 L IY UW
vencer|V S EH0 R
vencido|V S IY DH UW
vencilho|V S IY L IY UW
vencimento|V S IY M T UW
venda|V D AA
vendar|V D AE R
vendas|V D AA SH
vender|V D EH0 R
vendo|V D UW
venenoso|V IH0 N IH0 N OW0 Z UW
veneração|V IH0 N IH0 R AA S AA W
venhas|V AA N IY0 AA SH
venial|V IH0 N Y AE L
venta|V T AA
ventana|V T AA N AA
vento|V T UW
ventoinha|V T W IY N IY0 AA
ventos|V T UW SH
ventoso|V T OW0 Z UW
ventre|V T R IH0
ventura|V T UW R AA
ventã|V T AA
verbasco|V IH0 R V AE SH K UW
verbo|V EH R V UW
verbosamente|V EH R V OW0 Z AA M T IH0
verboso|V IH0 R V OW0 Z UW
verdade|V IH0 R D AE D IH0
verdadeira|V IH0 R DH AA DH AA Y R AA
verdadeiramente|V IH0 R DH AA DH AA Y R AA M T IH0
verdadeiras|V IH0 R DH AA DH AA Y R AA SH
verdadeiro|V IH0 R DH AA DH AA Y R UW
verdadeiros|V IH0 R DH AA DH AA Y R UW SH
verdades|V IH0 R DH AE DH IH0 SH
verdes|V EH0 R DH IH0 SH
veremos|V IH0 R EH0 M UW SH
vergel|V IH0 R ZH EH L
vermelha|V IH0 R M AA L IY AA
vermelhos|V IH0 R M AA Y L IY UW SH
verniz|V IH0 R N IY SH
vero|V EH R UW
verso|V EH R S UW
versos|V EH R S UW SH
verás|V IH0 R AE SH
vestida|V IH0 SH T IY DH AA
vestido|V IH0 SH T IY DH UW
vestidos|V IH0 SH T IY DH UW SH
vestimenta|V IH0 SH T IY M T AA
vestir|V IH0 SH T IY R
vestiário|V IH0 SH T Y AE R Y UW
vestuário|V IH0 SH T W AE R Y UW
vesícula|V IY Z IY K UW L AE
vetar|V IH0 T AE R
veto|V EH T UW
vexame|V EH0 SH AA M IY
vezinha|V EH0 Z IY N IY0 AA
veículo|V AA IY K UW L UW
vi|V IY
via|V IY AA
viagem|V Y AE ZH AA Y
viagens|V IY AE ZH SH
viajado|V IY AA ZH AE DH UW
viajar|V IY AA ZH AE R
vibrar|V IY V R AE R
viciado|V IY S IY AE D UW
viciar|V IY S Y AE R
videira|V IY DH AA Y R AA
vidigueira|V IY DH IY HH AA Y R AA
vidrar|V IY DH R AE R
vidraria|V IY DH R AA R IY AA
vidraça|V IY DH R AE S AA
vidreiro|V IY DH R AA Y R UW
vidro|V IY DH R UW
vidros|V IY DH R UW SH
vieira|V Y AA Y R AA
viela|V Y EH L AA
vigente|V IY ZH T IH0
vigoroso|V IY HH UW R OW0 Z UW
vigésimo|V IY ZH EH Z IY M UW
vila|V IY L AA
vilancete|V IY L AA S EH0 T IH0
vilancico|V IY L AA S IY K UW
vilhancico|V IY L IY AA S IY K UW
vilã|V IY L AA
vilão|V IY L AA W
vim|V
vimioso|V IY M IY OW0 Z UW
vinagrete|V IY N AE G R EH T SH IY
vincar|V K AE R
vincilho|V S EH0 L IY UW
vinda|V D AA
vindimar|V D IY M AE R
vindo|V D UW
vindouro|V D OW0 W R UW
vingança|V G AA S AA
vingar|V G AE R
vinhais|V IY N IY0 AE Y SH
vinho|V IY N IY0 UW
vinhos|V IY N IY0 UW SH
vini|V IY N IY
vintém|V T Y
viola|V Y AO L AA
violação|V Y UW L AA S AA W
violentamente|V Y UW L T AA M T IH0
violento|V Y UW L T UW
violinista|V Y UW L IY N IY SH T AA
violino|V Y UW L IY N UW
violência|V Y UW L S Y AA
vira|V IY R AA
viram|V IY R AA W
virar|V IY R AE R
virgem|V IY R ZH AA Y
virgindade|V IY R ZH D AE DH IH0
viria|V IY R IY AA
viriam|V IY R IY AA W
virilha|V IY R IY L IY AA
virilidade|V IY R IY L IY DH AE DH IH0
virou|V IY R OW0 W
virtuoso|V IY R T W OW0 Z UW
virulento|V IY R UW L T UW
virá|V IY R AE
virão|V IY R AA W
visar|V IY Z AE R
viseu|V IY Z EH0 W
visita|V IY Z IY T AA
visitar|V IY Z IY T AE R
visitas|V IY Z IY T AA SH
vislumbre|V IY ZH L B R IH0
visom|V IY Z
vista|V IY SH T AA
vistoso|V IY S T OW0 Z UW
visão|V IY Z AA W
visível|V IY Z IY V EH L
visões|V IY Z Y SH
vitamina|V IY T AE M IY N AA
vitimar|V IY T IY M AE R
vitorioso|V IY T UW R Y OW0 Z UW
vitrificar|V IY T R IY F IY K AE R
vitória|V IY T AO R Y AA
viu|V IY W
viva|V IY V AA
vivam|V IY V AA W
vivar|V IY V AE R
vivaz|V IY V AE SH
vivenciar|V IY V S Y AE R
vivenda|V IY V D AA
vivendo|V IY V D UW
vivera|V IY V EH0 R AA
viveu|V IY V EH0 W
vivi|V IY V IY
vivia|V IY V IY AA
vivo|V IY V UW
vivos|V IY V UW SH
vizela|V IY Z EH L AA
vizinha|V IH0 Z IY N IY0 AA
vizinhança|V IH0 Z IY N IY0 AA S AA
viço|V IY S UW
viçoso|V IY S OW0 Z UW
viúvo|V Y UW V UW
voa|V OW0 W AA
voador|V W AA DH OW0 R
voadora|V W AA DH OW0 R AA
voando|V W AA D UW
voar|V W AE R
voara|V W AE R AA
voará|V W AA R AE
vocabulário|V UW K AA V UW L AE R Y UW
você|V AO S EH0
vocês|V AO S EH0 SH
vogar|V UW HH AE R
volição|V UW L IY S AA W
voltado|V AO L T AE DH UW
voltando|V AO L T AA D UW
voltar|V AO L T AE R
voltara|V OW0 L T AE R AA
voltará|V OW0 L T AA R AE
voltas|V AO L T AA SH
voltasse|V AO L T AE S IH0
voltava|V AO L T AE V AA
voltear|V AO L T Y AE R
volto|V AO L T UW
voltou|V AO L T OW0 W
voluntário|V UW L T AE R Y UW
voluptuoso|V UW L UW P T W OW0 Z UW
voluptuário|V UW L UW P T W AE R Y UW
volver|V OW0 L V EH0 R
vontade|V T AE DH IH0
vontades|V T AE DH IH0 SH
voo|V OW0 UW
voragem|V UW R AE ZH Y
vossa|V AO S AA
vosso|V AO S UW
voto|V AO T UW
vou|V OW0 W
vouga|V OW0 W HH AA
vouzela|V OW0 W Z EH L AA
vozear|V OW0 Z IY AE R
vozes|V AO Z IH0 SH
voçoroca|V OW0 S OW0 R AO K AE
vulgarmente|V UW L HH AE R M T IH0
vulnerar|V UW L N IH0 R AE R
vulnífico|V UW L N IY F IY K UW
vulto|V UW L T UW
vuvuzela|V UW V UW Z EH L AA
vá|V AE
vácuo|V AE K W UW
várias|V AE R Y AA SH
vário|V AE R Y UW
vários|V AE R Y UW SH
vã|V AA
vão|V AA W
véi|V EH Y
véio|V EH Y UW
véspera|V EH SH P IH0 R AA
véu|V EH W
vê|V EH0
vício|V IY S Y UW
vínico|V IY N IY K UW
vítima|V IY T IY M AA
vós|V AO SH
x|SH
xampu|SH AA P UW
xamã|SH AA M AA
xavecar|SH AE V EH0 K AE RH
xaveco|SH AE V EH K UW
xavier|SH AA V Y EH R
xelim|SH IH0 L
xereca|SH EH0 R EH K AE
xiita|SH IY IY T AA
xilindró|SH IY L D R AO
xingava|SH G AE V AA
xituculumucumba|SH IY T UW K UW L UW M UW K B AA
xixa|SH IY SH AA
xixi|SH IY SH IY
xota|SH AO T AA
xurumbambo|SH UW R B AA B UW
xá|SH AE
xícara|SH IY K AA R AA
yukiko|Y UW K IY K UW
yuko|Y UW K UW
yuri|Y UW R IY
yuriko|Y UW R IY K UW
zanga|Z AA G AA
zangado|Z AA G AE DH UW
zangam|Z AA G AA W
zangar|Z AA G AE R
zango|Z AA G UW
zangão|Z AA G AA W
zanza|Z AA Z AA
zarpar|Z AA R P AE R
zebra|Z EH0 V R AA
zebro|Z EH0 V R UW
zelador|Z IH0 L AA DH OW0 R
zelo|Z EH L UW
zepelim|Z IH0 P IH0 L
zero|Z EH R UW
zica|Z IY K AA
zilhão|Z IY L IY AA W
zimbro|Z B R UW
zinco|Z K UW
zincografia|Z K OW0 G R AE F IY AE
zona|Z OW0 N AA
zoneamento|Z OW0 N Y AA M T UW
zoo|Z W UW
zuca|Z UW K AA
zulu|Z UW L UW
zumbi|Z B IY
zumbir|Z B IY R
zunzum|Z Z
zurrapa|Z UW RH AE P AA
zás|Z AE SH
zâmbia|Z AA B Y AA
zângão|Z AA G AA W
zé|Z EH
zéfiro|Z EH F IY R UW
zê|Z EH0
à|AE
àquela|AE K EH L AA
àquelas|AE K EH L AA SH
àqueles|AE K EH0 L IH0 SH
àquilo|AE K IY L UW
á|AE
ádito|AE DH IY T UW
áfrica|AE F R IY K AA
ágrafo|AE HH R AA F UW
álcool|AE L K W AO L
árabe|AE R AA V IH0
árbitro|AE R V IY T R UW
árvores|AE R V UW R IH0 SH
áspero|AE SH P IH0 R UW
átrio|AE T R Y UW
â|AA
âmbito|AA B IY T UW
âncora|AA K UW R AA
ânfora|AA F UW R AA
ângulo|AA G UW L UW
ânsia|AA S Y AA
ã|AA
ç|S
é|EH
época|EH P UW K AA
érica|EH R IY K AA
étimo|EH T IY M UW
étnico|EH T N IY K UW
ênclise|K L IY Z IY
ícone|IY K AO N IH0
ímpar|P AE R
ímprobo|P R OW0 B UW
ínsula|S UW L AA
íntimo|T IY M UW
ípsilon|IY P S L AO N
ó|AO
óculo|AO K UW L UW
óculos|AO K UW L UW SH
óleo|AO L Y UW
ómega|AO M IH0 G AA
õ|
ú|UW
úngula|G UW L AA
única|UW N IY K AA
único|UW N IY K UW
útero|UW T EH0 R UW
útil|UW T IY L