a|AE
aarão|AE R AA W
abadan|AE B AE D AA
abade|AE B AE D ZH IY
abafadamente|AE B AE F AE D AE M T IY
abatiá|AE B AE T Y AE
abaxial|AE B AE K IY S IY AE W
abdomes|AE B D AO M EH0 SH
abecedário|AE B EH0 S EH0 D AE R Y UW
abelardo|AE B EH0 L AE RH D UW
abiu|AE B IY W
abobado|AE B OW0 B AE D UW
abordagem|AE B OW0 RH D AE ZH Y
abotoadura|AE B OW0 T OW0 AE D UW R AA
abrandamento|AE B R AA D AA M T UW
abrandar|AE B R AA D AE RH
abrangência|AE B R AA ZH S Y AE
abrasax|AE B R AE S AE K S
abraão|AE B R AA W
abraçável|AE B R AE S AE V EH0 W
abração|AE B R AE S AA W
abrigado|AE B R IY G AE D UW
abruptamente|AE B R UW P T AE M T IY
abrupto|AE B R UW P T UW
absalão|AE B S AE L AA W
absinto|AE B S T UW
absonância|AE B S OW0 N AA S Y AE
abstenção|AE B SH T S AA W
absurdo|AE B S UW RH D UW
abundância|AE B D AA S Y AE
acabar|AE K AE B AE HR
acabou|AE K AE B OW0 W
academia|AE K AE D EH0 M IY AE
academizar|AE K AE D EH0 M IY Z AE RH
acaia|AE K AE Y AA
acalmar|AE K AE W M AE RH
acamado|AE K AA M AE D UW
acanhado|AE K AA N IY0 AE D UW
acapulco|AE K AE P UW W K UW
accra|AE K R AA
acebolado|AE S EH0 B OW0 L AE D UW
aceitabilidade|AE S EH0 Y T AE B IY L IY D AE D IY
aceitar|AE S EH0 Y T AE RH
acelerar|AE S EH0 L EH0 R AE RH
acender|AE S D EH0 RH
aceno|AE S EH0 N UW
acepipe|AE S EH0 P IY P IY
acertar|AE S EH0 RH T AE RH
acerto|AE S EH RH T UW
acervo|AE S EH0 V UW
aceso|AE S EH0 Z UW
acessar|AE S EH0 S AE RH
acessivelmente|AE S EH0 S IY V EH0 W M T IY
acesso|AE S EH S UW
acha|AE SH AA
acham|AE SH AA W
achaparrado|AE SH AE P AE RH AE D UW
achaparrar|AE SH AE P AE RH AE R
achaque|AE SH AE K IY
achismo|AE SH IY Z M UW
acho|AE SH UW
acidente|AE S IY D T SH IY
acne|AE K N IY
acolher|AE K OW0 L IY EH0 R
acomodar|AE K OW0 M OW0 D AE RH
aconselhar|AE K S EH0 L IY AE RH
acontecer|AE K T EH S EH0 HH
acorrentado|AE K OW0 RH T AE D UW
acostar|AE K OW0 S T AE RH
acostumar|AE K OW0 S T UW M AE RH
acovardar|AE K OW0 V AE RH D AE RH
acra|AE K R AA
acreditar|AE K R EH0 D IY T AE RH
acrescentar|AE K R EH0 S T AE RH
acrobacia|AE K R OW0 B AE S IY AA
acrobata|AE K R OW0 B AE T AA
acrograma|AE K R OW0 G R AA M AA
acréscimo|AE K R EH S IY M UW
acurácia|AE K UW R AE S Y AE
acádia|AE K AE D IY AA
acústica|AE K UW S T IY K AA
adad|AE D AE D
adaptabilidade|AE D AE P T AE B IY L IY D AE D IY
adaptação|AE D AE P IY T AE S AA W
adarga|AE D AE R G AA
adedanha|AE D EH0 D N IY0 AE
adelo|AE D EH L UW
adentrar|AE D T R AE RH
adequar|AE D EH0 K W AE RH
aderência|AE D EH0 R S Y AE
adesão|AE D EH0 Z AA W
adeus|AE D EH0 W SH
adeusinho|AE D EH0 W Z IY N IY0 UW
adicionar|AE D IY S Y OW0 N AE RH
adivinhar|AE D ZH IY V IY N IY0 AE RH
adição|AE D IY S AA W
admin|AE D M
administrar|AA D M IY N IY SH T RRR AE RRR
admirador|AE D IY M IY R AE D OW0 RH
admitir|AE D M IY T IY RH
admoestar|AA D M W EH SH T AE RRR
adoecer|AE D UW EH0 S EH0 RH
adolescência|AE D UW L EH0 S S IY AA
adonai|AE D OW0 N AE Y
adorar|AE D OW0 R AE RH
adquirir|AE D ZH K IY R IY RH
adrianópolis|AE D R IY AA N AO P OW0 L IY S
adrião|AE D R IY AA W
adscrito|AE D IY S K R IY T UW
adsorção|AE D S OW0 RH S AA W
aduela|AA D W EH L AA
adular|AA D UW L AE R
adulto|AE D UW W T UW
advento|AE D V T UW
advogado|AE D V OW0 G AE D UW
advérbio|AE D ZH IY V EH B IH UH
adélio|AE D EH L Y UW
aeromoça|AE EH R OW0 M OW0 S AA
aeroporto|AE EH RRR OW0 P OW0 R T UW
aerólito|AE IY R AO L IY T UW
afagar|AA F AA G AE R
afago|AA F AE G UW
afastamento|AE F AE SH T AE M T UW
afastar|AE F AE S T AE RH
afazendar|AA F AA Z D AE RRR
afeiçoar|AA F AA Y S W AE RRR
afeição|AE F EH0 Y S AA W
afetar|AE F EH0 T AE HR
afiado|AE F Y AE D UW
afiançar|AA F Y AA S AE R
afigurar|AA F IY G UW R AE R
afinar|AE F IY N AE RH
afinidade|AE F IY N IY D AE D IY
afirmar|AE F IY RH M AE RH
afirmação|AE F IY RH M AE S AA W
afixar|AA F IY K S AE R
aflijamos|AE F L IY ZH AA M UW S
aflição|AE F L IY S AA W
afoito|AE F OW0 Y T UW
afrodite|AE F R OW0 D IY T IY
afrodito|AE F R OW0 D IY T UW
afta|AE F T AA
agadá|AE G AE D AE
agaloar|AA G AA L W AE R
agarrar|AE G AE RH AE RH
agastamento|AE G AE S T AE M T UW
ageu|AE ZH EH0 W
agiotagem|AE ZH Y OW0 T AE ZH Y
agir|AE ZH IY RH
agiria|AE ZH IY R IY AA
agitadamente|AE ZH IY T AE D AE M T IY
aglomerastes|AE G L OW0 M EH0 R AE S T IY S
agonizar|AE G N IY Z AE HR
agorinha|AE G AO R IY N IY0 AA
agostinho|AE G OW0 S T IY N IY0 UW
agradar|AE G R AE D AE RH
agradecemos|AE G RRR AE D EH0 S EH0 M UW SH
agradecer|AE G R AE D EH0 S EH0 RH
agradecimento|AE G R AE D EH0 S IY M Y T UW
agradável|AE G R AE D AE V EH0 W
agrigento|AE G R IY ZH T UW
agrícola|AE G R IY K OW0 L AA
aguado|AE G W AE D UW
aguante|AE G W AA T IY
aguar|AE G W AE RH
aguardente|AE G W AE RH D T IY
aguerrido|AE G EH0 RH IY D UW
aguçado|AE G UW S AE D UW
ah|AE
aham|AA HH AA
ai|AE Y
aids|AE Y D S
aidético|AE Y D EH T SH IY K UW
ainhum|AE Y N IY0
aio|AE Y UW
aipim|AE Y P
airbag|EH R B EH G IY
airela|AE Y R EH L AA
airoso|AE Y R OW0 Z UW
aja|AE ZH AA
ajoelhar|AE ZH OW0 EH0 L IY AE RH
ajustar|AE ZH UW S T AE RH
akita|AE K IY T AA
al|AE W
ala|AE L AA
aladim|AE L AE D
alado|AE L AE D UW
alambique|AE L AA B IY K IY
alameda|AE L AE M EH D AA
alan|AE L AA
alana|AE L AA N AA
alaranjado|AE L AE R AA ZH AE D UH
alastrim|AE L AE S T R
alcaloide|AE W K AE L AO Y D IY
alcance|AE W K AA S IY
alcancia|AE W K AA S IY AA
alcanzia|AE W K AA Z IY AA
alcançar|AE W K AA S AE RH
alcanço|AE W K AA S UW
alcateia|AE W K AE T EH0 Y AA
alcatrão|AE W K AE T R AA W
alcorão|AE W K OW0 R AA W
aldeia|AE W D EH0 Y AA
alegação|AE L EH0 G AE S AA W
alegrete|AE L EH0 G R EH0 T IY
aleijado|AE L EH0 Y ZH AE D UW
aleluia|AE L EH0 L UW Y AA
alentejo|AE L T EH ZH UW
alepo|AE L EH P UW
aleppo|AE L EH P UW
alerta|AE L EH RH T AA
alertamente|AE L EH RH T AE M T IY
alessandro|AE L EH0 S AA D R UW
alexander|AE L EH0 K S AA D EH0 RH
alexandre|AE L EH0 SH AA D R IY
alfabetização|AE W F AE B EH0 T IY Z AE S AA W
alfabeto|AE W F AE B EH T UW
alfacinha|AE W F AE S IY N IY0 AA
alfarrobeira|AE W F AE RH OW0 B EH0 Y R AA
alfinete|AE W F IY N EH T SH IY
alfisol|AE W F IY S AO W
alfonso|AE W F S UW
alforria|AE W F OW0 RH IY AA
algum|AE W G
alguma|AE W G M AA
algumas|AE W G M AA S
alguns|AE W G S
algures|AE W G UW R IY S
alguém|AE W G Y
alho|AE L IY UW
ali|AE L IY
alicate|AE L IY K AE T IY
alicatear|AE L IY K AE T EH0 AE R
alice|AE L IY S IY
alienação|AE L IY EH0 N AE S AA W
alienígena|AE L IY EH0 N IY ZH EH0 N AE
aline|AE L IY N IY
alinhado|AE L IY N IY0 AE D UW
almanjarra|AE W M AA ZH AE RH AA
alminha|AE W M IY N IY0 AA
alminhas|AE W M IY N IY0 AA S
almofada|AE W M UW F AE D AA
almoxarifado|AE W M OW0 SH AE R IY F AE D UW
almoçar|AE W M OW0 S AE RH
almoção|AE W M OW0 S AA W
almude|AE W M UW D IY
aloísio|AE L UW IY Z Y UW
alpendre|AE W P D R IY
alsácia|AE W S AE S Y AA
altear|AE W T EH0 AE R
alternativa|AE W T EH0 RH N AE T SH IY V AA
altinho|AE W T N IY0 UW
altura|AE W T UW R AA
altão|AE W T AA W
altíssimo|AE W T IY S IY M UW
altônia|AE W T OW0 N Y AA
aluado|AE L W AE D UW
alude|AE L UW D IY
aluna|AE L N AA
alunas|AE L N AA SH
alvacenta|AE W V AE S T AE
alvacento|AE W V AE S T UW
alvino|AE W V IY N UW
alvorotando|AE W V OW0 R OW0 T AA D UW
alvorotar|AE W V OW0 R OW0 T AE RH
alvoroçar|AE W V OW0 R OW0 S AE RH
alvoroço|AE W V OW0 R AO S UW
alá|AE L AE
alívio|AE L IY V Y UW
alófono|AE L AO F OW0 N UW
alô|AE L OW0
amadeu|AE M AE D EH0 W
amaneirar|AE M AA N EH0 Y R AE R
amanhecer|AE M AA N IY0 EH0 S EH0 RH
amanteigado|AE M AA T EH0 Y G AE D UW
amaporã|AE M AE P OW0 R AA
amar|AA M AE RH
amaral|AA M AE R AE W
amarone|AA M AE R OW0 N IY
amassar|AE M AE S AE RH
amaury|AE M AE W R IY
amavio|AE M AE V IY UW
amavioso|AE M AE V IY OW0 Z UW
amazonita|AA M AA Z UW N IY T AA
amazonítico|AA M AA Z UW N IY T IY K UW
ambas|AA B AA S
ambientes|AA B IY T SH IY S
ambição|AA B IY S AA W
ambos|AA B UW S
ambrósio|AA B R AO Z Y UW
ambíguo|AA B IY G W UW
ameaça|AE M EH0 AE S AA
ameno|AA M EH0 N UW
americana|AE M EH0 R IY K AA N AA
amiga|AE M IY G AE
amigar|AA M IY G AE RH
amigdalite|AA M IY D AE L IY T IY
amistoso|AE M IY SH T OW0 Z UW
amolar|AE M OW0 L AE R
amontoado|AA M T UW AE D UW
amoroso|AE M OW0 R OW0 Z UW
amortizai|AE M OW0 RH T IY Z AE Y
amplo|AA P L UW
ampola|AA P OW0 L AA
ampulheta|AA P UW L IY EH0 T AA
amuleto|AE M UW L EH0 T UH
amália|AE M AE L Y AA
amélia|AE M EH L Y AA
américa|AE M EH R IY K AA
amílcar|AE M IY W K AE RH
amós|AE M AO S
analisar|AA N AE L IY Z AE RH
analista|AE N AE L IY SH T AA
anarquia|AE N AE RH K IY AA
anastácio|AE N AE S T AE S Y UW
anastásio|AE N AE S T AE Z Y UW
anca|AA K AA
ancho|AA SH UW
anchova|AA SH OW0 V AA
anchovado|AA SH OW0 V AE D UW
anchoveta|AA SH OW0 V EH0 T AA
ancinho|AA S IY N IY0 UW
ancora|AA K AO R AA
ancorar|AA K OW0 R AE RH
anda|AA D AA
andaime|AA D AE Y M IY
andam|AA D AA W
andando|AA D AA D UW
andar|AA D AE RH
andava|AA D AE V AA
andes|AA D IY S
andirá|AA D IY R AE
ando|AA D UW
andou|AA D OW0 W
andrajo|AA D R AE ZH UW
andrajoso|AA D R AE ZH OW0 Z OW0
andressa|AA D R EH0 S AE
andré|AA D R EH
andrômeda|AA D R OW0 M EH0 D AA
anedonia|AE N EH0 D OW0 N IY AA
anedota|AA N EH0 D AO T AA
anelisa|AA N EH0 L IY Z AA
anestésico|AE N EH0 S T EH Z IY K UW
anexo|AA N EH K S UW
anfifílico|AA F IY F IY L IY K UW
angelim|AA ZH EH0 L
angola|AA G AO L AA
anguila|AA G W IY L AA
anguloso|AA G UW L OW0 Z UW
angélica|AA ZH EH L IY K AA
anilina|AE N IY L IY N AE
animais|AA N IY M AE Y S
animam|AA N IY M AA W
animar|AE N IY M AE RH
anime|AE N IY M IY
animosidade|AA N IY M OW0 Z IY D AE D IY
animê|AE N IY M EH0
aninhado|AE N IY N IY0 AE D UW
aninho|AA N IY N IY0 UW
anita|AA N IY T AA
anjo|AA ZH UW
anjou|AA ZH UW
anotação|AE N OW0 T AE S AA W
anselmo|AA S EH W M UW
ansim|AA S
anta|AA T AA
anteontem|AA T Y T Y
antepara|AA T EH0 P AE R AE
anteporia|AA T EH0 P OW0 R IY AE
anterior|AA T EH0 R IY OW0 RH
anterretrasado|AA T SH IY RH EH0 T R AE Z AE D UW
antibullying|AA T IY B UW L
anticoagulante|AA T IY K OW0 AE G UW L AA T IY
anticristo|AA T IY K R IY S T UW
anticultural|AA T IY K UW W T UW R AE W
antiderrapante|AA T IY D EH0 RH AE P AA T IY
antidopagem|AA T IY D OW0 P AE ZH Y
antifumo|AA T IY F UW M UW
antigamente|AA T IY G AE M T IY
antimonárquico|AA T IY M OW0 N AE RH K IY K UW
antimoral|AA T IY M OW0 R AE W
antitético|AA T IY T EH T IY K UW
antivacinação|AA T IY V AE S IY N AE S AA W
antonieta|AA T OW0 N Y EH0 T AA
antonina|AA T OW0 N IY N AA
antropofagia|T R OW0 P OW0 F AE ZH IY AE
antuérpia|AA T UW EH RH P Y AA
antífona|AA T IY F OW0 N AE
antônio|AA T OW0 N Y UW
anuir|AE N UW IY RRR
anuência|AE N UW S Y AE
análise|AA N AE L IY Z IY
aníbal|AA N IY B AE W
anúbis|AE N UW B IY S
ao|AE W
apaixonar|AE P AE Y SH OW0 N AE RH
apalaches|AE P AE L AE SH IY S
apalpadela|AE P AE W P AE D EH L AA
apalpadelas|AE P AE W P AE D EH L AA S
apanhado|AE P AA N IY0 AE D UW
apanhar|AE P AA N IY0 AE HR
aparato|AE P AE R AE T UW
aparece|AE P AE R EH S IY
aparecer|AE P AE R EH0 S EH0 RH
aparelho|AE P AE R EH L IY UW
aparentar|AE P AE R T AE RH
aparente|AE P AE R T IY
aparte|AE P AE RH T IY
aparência|AE P AE R S Y AA
apatetado|AE P AE T EH0 T AE D UW
apavorado|AE P AE V OW0 R AE D UW
apaziguamento|AE P AE Z IY G W AE M T UW
apelo|AE P EH0 L UW
apeninos|AE P EH0 N IY N UW S
aperfeiçoar|AA P EH0 R F EH0 Y S OW0 AE R
apertar|AE P EH0 RH T AE RH
apetite|AE P IY T IY T IY
apetência|AE P EH0 T S IY AA
aplacar|AA P L AA K AE RRR
apoderar|AE P OW0 D EH0 R AE RH
apoiar|AE P OW0 Y AE RH
apontamento|AE P T AE M T UW
apontar|AE P T AE RH
aporrinhação|AE P OW0 HH IY N IY0 AE S AA W
aposentadoria|AE P OW0 Z T AE D OW0 R IY AA
aposentar|AE P OW0 Z T AE RH
apreciar|AE P R EH0 S IY AE RH
apresenta|AE P R EH0 Z T AA
apresentam|AE P R EH0 Z T AA W
apresentar|AE P R EH0 Z T AE RH
apresentaram|AE P R EH0 Z T AE R AA W
apressar|AE P R EH0 S AE RH
apreço|AE P R EH S UW
aprimorar|AE P R IY M OW0 R AE RH
apropriado|AE P R OW0 P R IY AE D UW
aproveitar|AE P R OW0 V EH0 Y T AE HH
apurar|AE P UW R AE HR
apuro|AE P UW R UW
apúlia|AE P UW L Y AA
aquendar|AE K W D AE R
aquino|AE K IY N UW
arado|AE R AE D UW
arainha|AE R AA IY N IY0 AE
arando|AE R AA D UW
aranhiço|AE R AA N IY0 IY S UW
aranhiços|AE R AA N IY0 IY S UW
arapoti|AE R AE P OW0 T IY
arapuã|AE R AE P UW AA
araruna|AE R AE R UW N AA
arau|AE R AE W
araucária|AE R AE W K AE R IY AA
araújo|AE R AE UW ZH UW
arbitramento|AE RH B IY T R AA M T UW
arca|AE RH K AA
arcanjo|AE HR K AA ZH UW
arcano|AE RH K AA N UW
arcar|AE RH K AE RH
arconte|AE RH K T IY
arcádia|AE RH K AE D IY AA
arder|AE RH D EH0 RH
arejado|AE R EH0 ZH AE D UW
arenoso|AE R EH0 N OW0 Z UW
argel|AE RH ZH EH W
argola|AE RH G AO L AE
argumentar|AE RH G UW M T AE RH
argumento|AE RH G UW M T UW
ariano|AE R IY AA N UW
ariele|AE R Y EH L IY
arigatô|AE R IY G AE T OW0
arlene|AE RH L EH0 N IY
arma|AE RH M AA
armado|AE RH M AE D UW
armamentista|AE RH M AE M T SH IY Y SH T AE
arminda|AE R M D AA
armindo|AE R M D UW
arminha|AE RH M IY N IY0 AA
armário|AE RH M AE R Y UW
armórica|AE RH M AO R IY K AA
arno|AE RH N UW
aro|AE R UW
aromatizar|AE R OW0 M AE T IY Z AE RH
arqueiro|AE RH K EH0 Y R UW
arquibaldo|AE RH K IY B AE W D UW
arquimedes|AE RH K IY M EH D IY S
arquivo|AE RH K IY V UW
arrais|AE RH AE Y SH
arranjado|AE RH AA ZH AE D UW
arranjar|AE RH AA ZH AE RH
arranque|AE RH AA K IY
arrastamento|AE RH AE SH T AA M T UW
arredondar|AE RH EH0 D D AE RH
arregalar|AE RH EH0 G AE L AE RH
arregimentar|AE RH EH0 ZH IY M T AE RH
arremete|AE RH EH0 M EH T SH IY
arrente|AE RH T IY
arrepiado|AE RH EH0 P Y AE D UW
arriscar|AE RH IY S K AE RH
arritmia|AE RH IY T IY M IY AA
arrivederci|AE RH IY V EH0 D EH0 RH T IY
arrojo|AE RH AO ZH UW
arroto|AE RH AO T UW
arrozinho|AE HH OW0 Y Z N IY0 UW
arruaça|AE RH UW AE S AE
arruinar|AE HH UW IY N AE RH
arrumador|AE RH UW M AE D OW0 RH
arte|AE HR T IY
artista|AE HR T SH IY SH T AA
artur|AE RH T UW RH
artística|AE RH T IY S T IY K AA
artísticas|AE RH T IY S T IY K AA S
artístico|AE RH T IY S T IY K UW
artísticos|AE RH T IY S T IY K UW S
arábico|AE R AE B IY K UW
asa|AE Z AA
asar|AE Z AE RH
ascenso|AE S S UW
ascensão|AE S S AA W
ascese|AE S EH Z IY
ascii|AE S K IY
ashanti|AE SH AA T IY
asno|AE ZH N UW
aspereza|AE S P EH0 R EH0 Z AA
assa|AE S AA
assassinato|AE S AE S IY N AE T UW
assaí|AE S AE IY
assegurar|AE S EH0 G UW R AE RH
assembleia|AE S B L EH Y AA
asserção|AE S EH0 RH S AA W
assessor|AE S EH0 S OW0 HR
assessorar|AE S EH0 S OW0 R AE HR
assessoria|AE S EH0 S OW0 R IY AE
assimilação|AE S IY M IY L AE S AA W
assinar|AE S IY N AE RH
assiriologia|AE S IY R Y OW0 L OW0 ZH IY AE
assistir|AE S IY SH T IY HR
assistência|AE S IY S T S Y AA
asso|AE S UW
assoalho|AE S UW AE L IY UW
assobio|AE S UW B IY UW
associais|AE S OW0 S Y AE Y S
associação|AE S OW0 S Y AE S AA W
assumir|AE S UW M IY RH
assunto|AE S T UW
assur|AE S UW R
assustador|AE S UW S T AE D OW0 RH
assustadores|AE S UW S T AE D OW0 R IY S
assíria|AE S IY R Y AA
astana|AE S T AA N AA
astenia|AE S T EH0 N IY AE
astorga|AE S T AO RH G AA
astride|AE S T R IY D IY
astro|AE S T R UW
astúcia|AE S T UW S IY AA
ata|AE T AA
atalaia|AE T AE L AE Y AA
atarracado|AE T AE RH AE K AE D UW
atarracar|AE T AE RH AE K AE R
atenas|AE T EH0 N AA S
atender|AE T D EH0 RH
atendimento|AE T D IY M T UW
atenção|AE T S AA W
aterrissar|AE T EH0 RH IY S AE RH
aterrizagem|AE T EH0 RH IY Z AE ZH Y
aterro|AE T EH RH UW
aterrou|AE T EH0 RH OW0 W
ateísmo|AE T EH0 IY Z M UW
ateísta|AE T EH0 IY S T AA
atinente|AE T IY N T IY
atingir|AE T ZH IY RH
atitude|AE T SH IY T UW D ZH IY
ativar|AE T IY V AE RH
atividade|AE T IY V IY D AE D IY
atlântico|AE T L AA T IY K UW
atmosfera|AE T SH M OW0 S F EH R AA
ato|AE T UW
atraente|AE T R AE T SH IY
atrair|AE T R AE IY RH
atrapalhar|AE T R AE P AE L IY AE RH
atrasado|AE T R AE Z AE D UW
atraso|AA T R AE Z UW
atravessar|AE T R AE V EH0 S AE RH
atribular|AE T RRR IY B UW L AE HR
atrito|AE T R IY T UW
atrás|AE T R AE Y SH
atum|AE T
aturar|AE T UW R AE RH
aturo|AE T UW R UW
audiência|AE W D ZH IY S Y AA
aula|AE W L AA
aulinha|AE W L IY N IY0 AA
aumentar|AE W M T AE HR
aumento|AE W M T UW
aura|AE W R AA
aurora|AE W R AO R AA
aurélia|AE W R EH L Y AA
aurélio|AE W R EH L Y UW
ausência|AE W Z S Y AA
autarca|AE W T AE RH K AA
autenticidade|AE W T T IY S IY D AE D IY
auto|AE W T UW
autobiográfico|AE W T OW0 B IY OW0 G R AE F IY K UW
autocolante|AE W T UW K OW0 L AA T IY
autoconsciente|AE W T OW0 K S IY T IY
autoevidente|AE W T UW EH0 V IY D T IY
automobilista|AE W T OW0 M OW0 B IY L IY S T AA
automobilistas|AE W T OW0 M OW0 B IY L IY S T AA S
autonômico|AE W T OW0 N M IY K UW
autora|AE W T OW0 R AA
autoridade|AE W T OW0 R IY D AE D IY
auxiliar|AE W S IY L Y AE RH
auxílio|AE W S IY L Y UW
avalanche|AE V AE L AA SH IY
avaliar|AE V AE L IY AE RH
avaliação|AE V AE L IY AE S AA W
ave|AE V EH
aventurado|AE V T UW R AE D UW
aventureiro|AE V T UW R EH0 Y R UW
avisar|AE V IY Z AE RH
avistamento|AE V IY SH T AE M T UW
avo|AE V UW
aya|AE Y AA
azagaia|AE Z AE G AE Y AA
azar|AE Z AE RH
azarento|AE Z AE RRR T UW
azedinha|AE Z EH0 D IY N IY0 AA
azedo|AA Z EH0 D UW
azeiteiro|AE Z EH0 Y T EH0 Y R UW
azo|AE Z UW
azáfama|AE Z AE F AA M AA
açafrão|AE S AE F R AA W
aço|AE S UW
açoite|AE S OW0 Y T IY
açougue|AE S OW0 W G IY
açucena|AE S UW S EH0 N AA
açude|AE S UW D IY
açular|AE S UW L AE RH
ação|AE S AA W
açúcar|AE S UW K AA HR
açúcares|AE S UW K AA R IY S
aécio|AE EH S Y UW
aéreo|AE EH R Y UW
aê|AE EH0
babalorixá|B AE B AA L OW0 R IY SH AE
babaçuê|B AE B AA S UW EH0
babe|B AE B IY
babista|B AE B IY S T AA
babosa|B AE B AO Z AA
baboseira|B AE B OW0 Z EH0 Y R AE
babou|B AE B OW0 W
babá|B AE B AE
bacana|B AE K AA N AA
bacharelas|B AE SH AE R EH L AA S
bacia|B AE S IY AA
bacu|B AE K UW
badameco|B AE D AE M EH K UW
bafo|B AE F UW
bagatela|B AE G AE T EH L AE
bagre|B AE G R IY
bahamas|B AE AA M AA S
baia|B AE Y AA
baiano|B AE Y AA N UW
bailanta|B AE Y L T AE
baita|B AE Y T AA
baitar|AE Y
baixada|B AE Y SH AE D AA
baixinho|B AE IY SH N IY0 UW
baixista|B AE Y SH IY S T AA
baixo|B AE Y SH UW
bala|B AE L AA
balada|B AE L AE D AA
balançar|B AE L AA S AE RH
balaço|B AE L AE S UW
balear|B AE L EH0 AE RH
baleares|B AE L EH0 AA R IY S
baleeiro|B AE L IY EH0 Y R UW
baliza|B AE L IY Z AA
balzaca|B AE W Z AE K AE
balzaquiana|B AE W Z AE K Y AA N AE
balzaquiano|B AE W Z AE K IY AA N UW
balázio|B AE L AE Z Y UW
balãozinho|B AE L AA W Z IY N IY0 UW
balé|B AE L EH
balípodo|B AE L IY P OW0 D UW
bamba|B AA B AA
bambo|B AA B UW
bambu|B AA B UW
banana|B AE N AA N AA
banca|B AA K AA
bancar|B AA K AE RH
banco|B AA K UW
banda|B AA D AA
bandeirantes|B AA D EH0 Y R AA T IY S
bandeja|B AA D EH0 ZH AE
bandido|B AA D IY D UW
bando|B AA D UW
bandolim|B AA D UW L
bangalô|B AA G AA L OW0
banguela|B AA G EH L AE
banhado|B AA N IY0 AE D UW
banheira|B AA N IY0 EH0 Y R AE
banir|B AA N IY RH
banza|B AA Z AA
banzo|B AA Z UW
barato|B AE R AE T UW
baraço|B AE R AE S UW
barba|B AE RH B AA
barbeador|B AE RH B Y AE D OW0 RH
barco|B AE RH K UW
barqueiro|B AE RH K EH0 Y R UW
barra|B AE RH AA
barracão|B AE RH AE K AA W
barro|B AE RH UW
bartolomeu|B AE RH T OW0 L OW0 M EH0 W
barulhinho|B AE R UW L IY IY N IY0 UW
barulho|B AE R UW L IY UW
baseado|B AE Z Y AE D UW
bastidor|B AE S T IY D OW0 RH
bata|B AE T AA
batatona|B AE T AE T OW0 N AA
batina|B AE T SH IY N AE
batom|B AA T
batráquio|B AE T R AE K Y UW
bauzinho|B AE UW Z IY N IY0 UW
bavária|B AE V AE R Y AA
bazar|B AE Z AE RH
bazófia|B AE Z AO F Y AE
baça|B AE S AA
baço|B AE S UW
baú|B AE UW
beatriz|B EH0 AE T R IY S
bebe|B EH B IY
bebedeira|B EH0 B EH0 D EH0 Y R AE
beber|B EH0 B EH0 RH
bebida|B EH0 B IY D AA
bebo|B EH0 B UW
bebê|B EH0 B EH0
beca|B EH K AA
beco|B EH0 K UW
bege|B EH ZH IY
beijinho|B EH0 Y ZH IY N IY0 UW
beijoqueiro|B EH0 Y ZH OW0 K EH0 Y R UW
beiço|B EH0 Y S UW
beja|B EH ZH AA
beladona|B EH L AE D OW0 N AE
beldade|B EH W D AE D IY
beleza|B EH0 L EH0 Z AA
belezura|B EH0 L EH0 Z UW R AE
belicista|B EH L IY S IY S T AA
beliscar|B EH0 L IY S K AE RH
belo|B EH L UW
belvedere|B EH W V EH0 D EH R IY
bemol|B EH0 M AO L
bemóis|B EH0 M AO Y SH
bend|B D
beneficiar|B EH0 N EH0 F IY S IY AE RH
benefício|B EH0 N EH0 F IY S Y UW
benemérita|B EH0 N EH0 M EH R IY T AA
benesse|B EH0 N EH S IY
benevento|B EH0 N EH0 V T UW
bengala|B G AE L AA
bengali|B G AE L IY
benignidade|B EH0 N IY G N IY D AE D ZH IY
benigno|B EH0 N IY G IY N UW
benta|B T AA
bento|B T UW
berilo|B EH0 R IY L UW
berlim|B EH0 RH L
berlinês|B EH RH L IY N EH0 S
bernardo|B EH0 RH N AE RH D UW
beslan|B EH0 Z L AA
besta|B EH0 S T AA
besteiro|B EH0 S T EH0 Y R UW
besteirol|B EH0 S T EH0 Y R AO W
betar|B EH0 T AE HR
bete|B EH T SH IY
betume|B EH0 T UW M IY
bexiga|B EH0 SH IY G AE
bezerro|B EH0 Z EH0 RH UW
bibliógrafo|B IY B L IY AO G R AE F UW
bicar|B IY K AE RH
bicha|B IY SH AA
bicho|B IY SH UW
bicicleta|B IY S IY K L EH T AA
bicla|B IY K L AA
bico|B IY K UW
bicuda|B IY K UW D AE
bicudo|B IY K UW D UW
bielorrusso|B Y EH L OW0 RH UW S UW
bigode|B IY G AO D IY
bilha|B IY L IY AA
bilhete|B IY L IY EH0 T SH IY
bilheteira|B IY L IY EH0 T EH0 Y R AA
bilheteiro|B IY L IY EH0 T EH0 Y R UW
bilhão|B IY L IY AA W
bilro|B IY W UW
bimba|B B AA
bimbar|B B AE RH
bingo|B G UW
biologista|B IY OW0 L OW0 ZH IY AE
bioquímica|B IY OW0 K IY M IY K AA
birra|B IY RH AA
biruta|B IY R UW T AA
bishkek|B IY SH K EH K
bissau|B IY S AE W
bistrô|B IY S T R OW0
bisu|B IY Z UW
bituca|B IY T UW K AA
bituruna|B IY T UW R UW N AA
bizâncio|B IY Z AA S Y UW
biônico|B IY OW0 N IY K UW
blenda|B L D AA
blica|B L IY K AA
blitz|B L IY T S
blocagem|B L OW0 K AE ZH Y
bloco|B L AO K UW
bluetooth|B L UW W T UW F
blusa|B L UW Z AA
boate|B UW AE T IY
boazinha|B OW0 AA Z N IY0 AA
boazona|B OW0 AE Z OW0 N AA
bob|B AO B IY
bobes|B AO B IY S
bobinar|B OW0 B IY N AE RH
bobo|B OW0 B UW
boboca|B OW0 B AO K AE
boca|B OW0 K AA
bocado|B UW K AE D UW
bocejo|B OW0 S EH0 ZH UW
bocha|B AO SH AA
bochicho|B UW SH IY SH UW
boco|B OW0 K UW
bocó|B OW0 K AO
boda|B OW0 D AA
boeing|B AO Y G
boi|B OW0 Y
boia|B AO Y AA
boiada|B OW0 Y AE D AA
boiadeiro|B OW0 Y AE D EH0 Y R UW
boiardo|B OW0 Y AE RH D UW
bola|B AO L AA
bolapé|B AO L AE P EH
boleto|B UW L EH0 T UW
bolha|B OW0 L IY AA
boliche|B OW0 L IY SH IY
bolo|B OW0 L UW
bolso|B OW0 W S UW
bolsominion|B OW0 W S OW0 M IY N Y
bolsonaro|B OW0 W S OW0 N AE R UW
bom|B
bomba|B B AA
bombaim|B B AE
bombar|B B AE RH
bombas|B B AA
bombava|B B AE V AA
bombeiro|B B EH0 Y R UW
bombo|B B UW
bombom|B B
bombril|B B R IY W
bonacheirão|B OW0 N AE SH EH0 Y R AA W
bonachão|B OW0 N AE SH AA W
bondoso|B D OW0 Z UW
boneca|B UW N EH K AA
bonina|B OW0 N IY N AA
bonitinho|B UW N IY T IY N IY0 UW
bonito|B OW0 N IY T UW
bonsai|B S AE Y
boné|B OW0 N EH
booleano|B UW L IY AA N UW
bope|B AO P IY
borboletear|B OW0 RH B OW0 L EH0 T EH0 AE RH
bordo|B AO RH D UW
bordoada|B UW R D UW AE D AA
boro|B AO R UW
borrazópolis|B OW0 RH AE Z AO P OW0 L IY S
bosque|B AO S K IY
bosquímano|B OW0 SH K IY M AA N UW
boston|B AO S T
bot|B AO T
bota|B AO T AA
boto|B AO T UW
bouça|B OW0 W S AA
box|B AO K S
bracelete|B R AE S EH0 L EH0 T SH IY
braganey|B R AE G AE N EH0 Y
branca|B R AA K AA
branco|B R AA K UW
brancura|B R AA K UW R AA
brando|B R AA D UW
brasa|B R AE Z AA
brasileiro|B R AA Z IY L EH0 Y R UW
brasilidade|B R AE Z IY L IY D AE D ZH IY
brasis|B R AE Z IY S
brava|B R AE V AA
bravateiro|B R AE V AE T EH0 Y R UW
bravo|B R AE V UW
bravura|B R AE V UW R AE
braço|B R AE S UW
breakdance|B R EH0 Y K IY D S IH
breca|B R EH K AA
brecha|B R EH SH AE
bregueço|B R EH0 G EH0 S UW
breja|B R EH ZH AE
brejeirar|B RRR EH0 ZH EH0 Y R AE RH
brejeirice|B RRR EH0 ZH EH0 Y R IY S IY
brejeiro|B R EH0 ZH EH0 Y R UW
brejo|B R EH ZH UW
bretão|B R EH0 T AA W
breu|B R EH0 W
breve|B R EH V IY
brida|B R IY D AA
briga|B R IY G AA
brigada|B R IY G AE D AA
brilha|B R IY L IY AA
brilhante|B R IY L IY AA T SH IY
brincadeira|B R K AE D EH0 Y R AA
brinco|B R K UW
brindisi|B R D ZH IY Z IY
brinquedo|B R K EH0 D UW
brisa|B R IY Z AA
brochura|B R OW0 SH UW R AE
broderagem|B R OW0 D EH0 R AE ZH Y
brodo|B R AO D UW
bronze|B R Z IY
broquel|B R OW0 K EH W
brotar|B R OW0 T AE RH
bruaca|B RRR UW AE K AE
bruges|B R UW ZH IY S
brusqueta|B R UW S K EH0 T AA
bruxa|B R UW SH AA
bruxelas|B R UW SH EH L AA S
bruxo|B R UW SH UH
brício|B R IY S Y UW
brígida|B R IY ZH IY D AA
bucha|B UW SH AA
buchicho|B UW SH IY SH UW
bucéfalo|B UW S EH F AE L UW
bucólico|B UW K AO L IY K UW
buda|B UW D AA
buffer|B AA F EH0 RH
buffet|B UW F EH0
bufo|B UW F UW
bufão|B UW F AA W
bufê|B UW F EH0
bug|B AA G IY
bugio|B UW ZH IY UW
bugre|B UW G R IY
bula|B UW L AA
bulbo|B UW W B UW
bulhufas|B UW L IY UW F AE S
buliçoso|B UW L IY S OW0 Z UW
bumbum|B B
bunda|B D AA
buque|B UW K IY
buquê|B UW K EH0
buraco|B UW R AE K UW
buscar|B UW S K AE RH
busão|B UW Z AA W
butão|B UW T AA W
buxo|B UW SH UW
bv|B EH0 V EH0
bypass|B AE Y P EH S
byte|B AE Y T SH IY
bácoro|B AE K OW0 R UW
bálcãs|B AE W K AA S
básico|B AE Z IY K UW
bão|B AA W
bélico|B EH L IY K UW
bétula|B EH T UW L AA
bê|B EH0
bênção|B S AA W
bíblia|B IY B L Y AA
bípede|B IY P EH0 D ZH IY
bóbi|B AO B IY
bóbis|B AO B IY S
bóris|B AO R IY S
bósforo|B AO S F OW0 R UW
bósnia|B AO Z N Y AA
búlgaro|B UW W G AE R UW
bússola|B UW S OW0 L AA
c|S EH0
cabaço|K AE B AE S UW
cabelo|K AE B EH0 L UW
cabeu|K AE B EH0 W
cabide|K AE B IY D IY
cabisbaixo|K AE B IY ZH B AE Y SH UW
cabral|K AE B R AE W
caca|K AE K AA
cacareco|K AE K AE RRR EH K UW
cachaça|K AE SH AE S AA
cache|K EH SH IY
cachecol|K AE SH EH0 K AO W
cacho|K AE SH UW
cachoeira|K AE SH UW EH0 Y R AA
cachopo|K AE SH OW0 P UW
cachê|K AE SH EH0
caco|K AE K UW
cacofonia|K AE K OW0 F OW0 N IY AA
cacto|K AE K T UW
cadastrar|K AE D AE S T R AE RH
cadeado|K AE D AE D UW
cadete|K AE D EH0 T IY
cadê|K AE D EH0
caetano|K AE EH0 T AA N UW
cafofo|K AE F OW0 F UW
cafona|K AE F OW0 N AE
cafoto|K AE F OW0 T UW
cafuné|K AE F UW N EH
cagueta|K AE G W EH T AE
caguetar|K AE G W EH0 T AE R
caguete|K AE G W EH T SH IY
cai|K AE Y
caia|K AE Y AA
caiais|K AE Y AE Y S
caiam|K AE Y AA W
caiamos|K AE Y AA M UW S
caias|K AE Y AA S
caiem|K AE Y Y
caim|K AA
caimão|K AE Y M AA W
caio|K AE Y UW
caipira|K AE Y P IY R AA
caixa|K AE Y SH AA
caixilho|K AE Y SH IY L IY UW
caixote|K AE Y SH AO T IY
caixão|K AE Y SH AA W
cajón|K AE RH
cala|K AE L AA
calafrio|K AE L AE F R IY W
calais|K AE L EH
calam|K AE L AA W
calcanhar|K AE W K AA N IY0 AE RH
calculadora|K AE W K UW L AE D OW0 RRR AE
calculação|K AE W K UW L AE S AA W
calcutá|K AE W K UW T AE
calebe|K AE L EH B IY
calgary|K AE W G AE R IY
calha|K AE L IY AA
calhorda|K AE L IY AO D AE
calibre|K AE L IY IY B R IY
califa|K AE L IY F AA
calistenia|K AE L IY S T EH0 N IY AE
calo|K AE L UW
caloroso|K AE L OW0 R OW0 Z UW
calouro|K AE L OW0 R UW
calvinismo|K AE W V IY N IY Z M UW
calão|K AE L AA W
calçada|K AE W S AE D AE
calças|K AE W S AA S
camada|K AE M AE D AE
camarada|K AE M AE R AE D AA
cambará|K AA B AE R AE
cambira|K AA B IY R AA
camboja|K AA B AO ZH AA
cambridge|K Y B R IY D
cambé|K AA B EH
camelódromo|K AE M EH0 L AO D R OW0 M UW
camelô|K AE M EH0 L OW0
camerlengo|K AE M EH0 RH L G UW
camila|K AA M IY L AA
caminhada|K AE M IY N IY0 AE D AE
caminhar|K AA M IY N IY0 AE RH
camisa|K AA M IY Z AA
camisola|K AA M IY Z AO L AA
camomila|K AE M OW0 M IY L AE
campesino|K AA P EH0 Z IY N UW
campestre|K AA P EH SH T R IY
campeã|K AA P IY AA
camping|K AA P
campo|K AA P UW
campânia|K AA P AA N IY AA
camundongo|K AE M D G UW
cananeu|K AA N AA N EH0 W
canaque|K AE N AE K IY
cancela|K AA S EH L AA
canceriano|K AA S EH0 R IY AA N UH
cancro|K AA K R UW
candango|K AA D AA G UW
candeeiro|K AA D Y EH0 Y R UW
candela|K AA D EH L AA
candidato|K AA D IY D AE T UW
candidatura|K AA D IY D AE T UW R AA
candil|K AA D IY W
candomblé|K AA D B L EH
candura|K D UW R AE
candói|K AA D AO Y
canela|K AA N EH L AA
canga|K AA G AA
cangambá|K AA G AA B AE
canguru|K AA G UW R UW
canil|K AA N IY W
canivete|K AA N IY V EH T EH0
canja|K AA ZH AA
canoa|K AA N OW0 AA
cansa|K AA S AA
cansaço|K AA S AE S UW
canseira|K AA S EH0 Y R AE
canso|K AA S UW
canta|K AA T AA
cantiga|K AA T IY G AA
cantina|K AA T IY N AE
canto|K AA T UW
cantor|K AA T OW0 RH
cantoria|K AA T OW0 R IY AA
cantuária|K AA T UW AE R IY AA
cantão|K AA T AA W
canudo|K AE N UW D UW
canção|K AA S AA W
caos|K AE W S
capa|K AE P AA
capacete|K AE P AE S EH0 T SH IY
capachinho|K AE P AE SH IY N IY0 UW
capacidade|K AE P AE S IY D AE D ZH IY
capacitância|K AE P AE S IY T AA S Y AE
capanema|K AE P AE N EH0 M AA
capetagem|K AE P EH0 T AE ZH Y
capetagens|K AE P EH0 T AE ZH SH
capitais|K AA P IY T AE IY SH
capitão|K AE P IY T AA W
capoeirista|K AE P UW EH0 Y R IY S T AA
caprichar|K AE P R IY SH AE RRR
capricho|K AE P R IY SH UW
capturar|K AE P T UW R AE RH
capturo|K AE P T UW R UW
caput|K AE P UW T
capuz|K AE P UW S
caqui|K AE K IY
cara|K AE R AA
caractere|K AE R AE K T EH R IY
característica|K AE R AE K T EH0 R IY S T SH IY K AA
carambeí|K AE R AA B EH0 IY
carambola|K AE R AA B AO L AE
caraminhola|K AE R AE M IY Y AO L AE
caranguejeira|K AE R AA G EH0 ZH EH0 Y R AA
carapau|K AE R AE P AE W
caratê|K AE R AE T EH0
caravela|K AE R AE V EH L AA
carcanhol|K AA R K AA N IY0 AO L
carente|K AE R T IY
cargas|K AE RH G AA SH
cargo|K AE RH G UW
carica|K AA RRR IY K AA
caricatura|K AE R IY K AE T UW R AE
caridade|K AE R IY D AE D IY
carlópolis|K AE RH L AO P OW0 L IY S
carniça|K AE RH N IY S AA
carnífice|K AE RH N IY F IY S IY
caro|K AE R UW
carola|K AE R AO L AE
carolina|K AE R OW0 L IY N AA
caroça|K AE R AO S AA
caroçama|K AE R OW0 S AA M AA
caroçudo|K AE R OW0 S UW D UW
carpete|K AE R P EH T SH IY
carpinteiro|K AE RH P T EH0 Y R UW
carpo|K AE P OW0
carranca|K AE RH AA K AA
carrapato|K AE RH AE P AE T UW
carrapicho|K AE RH AE P IY SH UW
carrasco|K AE RH AE SH K UW
carregar|K AE RH EH0 G AE RH
carreira|K AE RH EH0 Y R AA
carreta|K AA RH EH0 T AA
carro|K AE RH UW
carroça|K AE RH AO S AA
cartaz|K AE R T AE S
cará|K AE R AE
carícia|K AE R IY S Y AA
cas|K AE S
casa|K AE Z AA
casaco|K AE Z AE K UW
casam|K AE Z AA W
casamento|K AE Z AA M T UW
casco|K AE S K UW
caseiro|K AE Z EH0 Y R UW
caserna|K AE Z EH RH N AA
caso|K AE Z UW
cassino|K AE S IY N UW
castelo|K AE SH T EH L UW
castidade|K AE SH T IY D AE D IY
castigado|K AE SH T IY G AE D UW
castigo|K AE S T IY G UW
casulo|K AE Z UW L UH
cata|K AE T AA
catafalco|K AE T AE F AE W K UW
catam|K AE T AA W
catanduvas|K AE T AA D UW V AA S
cataplana|K AE T AE P L AA N AA
catapúcia|K AE T AE P UW S Y AE
catarina|K AE T AE R IY N AA
catarro|K AE T AE RH UW
catarse|K AE T AE RH S IY
catastrófica|K AE T AE S T R AO F IY K AA
catequista|K AE T EH0 K IY S T AE
cateter|K AE T EH T EH0 RH
catita|K AE T IY T AA
cativariam|K AE T IY V AE R IY AA W
cativo|K AE T IY V UW
cato|K AE T UW
catraio|K AE T R AE Y UW
caubói|K AE W B AO Y
causa|K AE W Z AA
causo|K AE W Z UW
cautelarmente|K AE W T EH0 L AE RH M T IY
cauto|K AE W T UW
cauã|K AE W AA
cauê|K AE W EH0
cava|K AE V AA
cavalete|K AE V AE L EH0 T SH IY
cavaquinho|K AE V AA K IY N IY0 UW
caveirão|K AE V EH0 Y R AA W
caviar|K AE V IY AE R
cavoucar|K AE V OW0 K AE HR
caxumba|K AE SH B AA
caça|K AE S AA
caçada|K AE S AE D AA
caçamba|K AA S B AA
caçarola|K AE S AE R AO L AE
caço|K AE S UW
caô|K AE OW0
ceco|S EH K UW
cecílio|S EH0 S IY L IY UW
cega|S EH G AA
cegas|S EH G AA S
cegueta|S EH0 G EH0 T AE
ceguinho|S EH G IY N IY0 UW
ceguinhos|S EH G IY N IY0 UW S
cela|S EH L AE
celebrar|S EH0 L EH0 B R AE RH
celebérrimo|S EH L EH0 B EH RH IY M UW
celeiro|S EH0 L EH0 Y R UW
celeste|S EH0 L EH SH T IY
celestial|S EH0 L EH0 SH T Y AE W
celeuma|S EH0 L EH0 W M AA
celular|S EH0 L UW L AE RH
cemitério|S EH0 M IY T EH R Y UW
censo|S S UW
censura|S S UW R AA
censurai|S S UW R AE Y
censuram|S S UW R AA W
censurando|S S UW R AA D UW
censurara|S S UW R AE R AA
censurava|S S UW R AE V AA
censuro|S S UW R UW
centauro|S T AE W R UW
centavo|S T AE V UW
cento|S T UW
centopeia|S T OW0 P EH Y AE
centro|S T R UW
centrípeto|S T R IY P EH0 T UW
centurião|S T UW R Y AA W
cepo|S EH0 P UW
cera|S EH0 R AA
cereal|S EH0 R IY AE W
cereja|S EH R EH0 ZH AE
cerimônia|S EH0 R IY M OW0 N Y AE
certamente|S EH HH T AE M T IY
certificar|S EH0 RH T IY F IY K AE RH
certinho|S EH RH T N IY0 UW
certíssimo|S EH RH T IY S IY M UW
cerva|S EH RH V AA
cervo|S EH0 RH V UW
cesareia|S EH Z AE R EH Y AA
cessa|S EH S AA
cesta|S EH0 S T AE
cetona|S EH0 T OW0 N AE
cetro|S EH T R UW
ceuta|S EH0 W T AA
chacina|SH AE S IY N AE
chacra|SH AE K R AA
chafariz|SH AE F AE R IY S
chaim|SH AE
chaleira|SH AE L EH0 Y R AE
chamada|SH AA M AE D AA
chamejar|SH AA M EH0 ZH AE HR
champignon|SH AA P IY N IY0
champô|SH AA P OW0
chanucá|RH AA N UW K AE
chapa|SH AE P AA
chapeada|SH AE P IY AE D AA
chapecoense|SH AE P EH0 K W S EH0
chapecó|SH AE P EH0 K AO
chapeuzinho|SH AE P EH W Z IY N IY0 UW
charada|SH AE R AE D AA
charamela|SH AE R AA M EH L AA
charque|SH AE RH K IY
charrete|SH AE RH EH T SH IY
chasco|SH AE SH K UW
chat|SH EH T SH IY
chateado|SH AE T IY AE D UW
chatear|SH AE T EH0 AE R
chato|SH AE T UW
chau|SH AE W
chavo|SH AE V UW
chavão|SH AE V AA W
checa|SH EH K AA
checagem|SH EH0 K AE ZH
checheno|SH EH0 SH EH0 N UW
cheddar|SH EH D AE RH
cheerleader|T IY EH0 RH L IY D EH0 RH
cheesecake|SH IY S K EH0 Y K IY
chefiar|SH EH0 F IY AE RH
chefão|SH EH F AA W
chefículo|SH EH F IY K UW L UW
chega|SH EH0 G AA
chegada|SH EH0 G AE D AE
cheia|SH EH0 Y AA
cheirar|SH EH0 Y R AE RH
cheque|SH EH K IY
chernobil|SH EH0 RH N OW0 B IY W
chibata|SH IY B AE T AE
chibo|SH IY B UW
chicho|SH IY SH UW
chico|SH IY K UW
chicotada|SH IY K OW0 T AE D AA
chicote|SH IY K AO T IY
chifre|SH IY F R IY
chili|T IY L IY
chimarrear|SH IY M AE RH EH0 AE RH
china|SH IY N AA
chinfrim|SH F R
chinês|SH IY N EH0 Y S
chiqueiro|SH IY K EH0 Y R UW
chisa|SH IY Z AA
chispa|SH IY SH P AA
chita|SH IY T AA
chocado|SH OW0 K AE D UW
chocalho|SH OW0 K AE L IY UW
chocante|SH OW0 K AA T IY
chocar|SH OW0 K AE RH
chocarreira|SH OW0 K AE RH EH0 Y R AA
chocho|SH OW0 SH UW
choco|SH OW0 K UW
chon|SH
chope|SH OW0 P IY
chopinzinho|SH OW0 P Z IY N IY0 UW
choque|SH AO K IY
chorar|SH OW0 R AE RH
choro|SH AO R UW
chororô|SH OW0 R OW0 R OW0
chorão|SH OW0 R AA W
choupana|SH OW0 W P AA N AA
choupo|SH OW0 W P UW
chouriço|SH OW0 W R IY S UW
chousura|SH OW0 W Z UW R AA
chovendo|SH OW0 V D UW
chuca|SH UW K AE
chufa|SH UW F AA
chufando|SH UW F AA D UW
chufara|SH UW F AE R AA
chuiva|SH UW Y V AA
chulca|SH UW W K AE
chulipa|SH UW L IY P AA
chulo|SH UW L UW
chulé|SH UW L EH
chumaço|SH UW M AE S UW
chumbo|SH B UW
chupar|SH UW P AE HR
chupeta|SH UW P EH0 T AA
chupim|SH UW P
chupisco|SH UW P IY SH K UW
churras|SH UW RH AE S
churrasco|SH UW RH AE SH K UW
chutar|SH UW T AE HH
chuto|SH UW T UW
chuva|SH UW V AA
chuvoso|SH UW V OW0 Z UW
chuá|SH UW AE
chuço|SH UW S UW
chá|SH AE
chádico|SH AE D IY K UW
chã|SH AA
chão|SH AA W
cianorte|S IY AA N AO RH T IY
ciclo|S IY K L UW
cidadezinha|S IY D AE D IY Z IY N IY0 AA
científico|S Y T SH IY F IY K UW
cifra|S IY F R AA
cifrão|S IY F R AA W
cilindrar|S IY L D R AE RH
cimenta|S IY M T AA
cimento|S IY M T UW
cinamomo|S IY N AA M OW0 M UW
cinco|S K UW
cinquenta|S K W T AA
cinto|S T UW
cintura|S T UW R AA
cinza|S Z AA
cinzenta|S Z T AE
cinzento|S Z T UW
cio|S IY UW
cipozal|S IY P OW0 Z AE W
cipozão|S IY P AO Z AA W
cipó|S IY P AO
circense|S IY HR S S IY
circulares|S IY RH K UW L AE R IY S
circuncentro|S IY RRR K S T RRR UW
circunstancia|S IY RH K S T AA S IY AA
circunstanciar|S IY RH K S T AA S Y AE RH
circunstância|S IY RH K S T AA S Y AA
cirenaica|S IY R EH0 N AE Y K AA
cireneu|S IY R EH0 N EH0 W
cirilo|S IY R IY L UW
cisco|S IY SH K UW
cisma|S IY Z M AA
cismar|S IY Z M AE RH
cisne|S IY ZH N IY
cisto|S IY S T UW
citadino|S IY T AE D IY N UW
citarista|S IY T AE R IY S T AA
cito|S IY T UW
civeta|S IY V EH0 T AA
clandestino|K L AA D EH0 S T IY N UW
clara|K L AE R AA
clarificar|K L AE R IY F IY K AE RH
claro|K L AE R UW
claríssima|K L AE R IY S IY M AA
claríssimo|K L AE R IY S IY M UW
classificação|K L AE S IY F IY K AE S AA W
clava|K L AE V AA
clemente|K L EH0 M T IY
cleptomania|K L EH P T OW0 M AA N IY AE
clero|K L EH R UW
clevelândia|K L EH0 V EH0 L AA D IY AA
clima|K L IY M AA
clio|K L IY UW
cloro|K L AO R UW
clube|K L UW B IY
cluster|K L AA S T EH0 RH
clássico|K L AE S IY K UW
cláudio|K L AE W D UW
clã|K L AA
clínica|K L IY N IY K AA
clínico|K L IY N IY K UW
coabitar|K OW0 AE B IY T AE RH
cobertor|K OW0 B EH0 RH T OW0 RH
cobra|K AO B R AE
cobrar|K OW0 B R AE RH
cobrir|K UW B R IY R
cochicho|K UW SH IY SH UW
cochinchina|K OW0 SH SH IY N AA
cociente|K OW0 S IY T IY
coclear|K OW0 K L IY AE RH
coco|K OW0 K UW
cocota|K OW0 K OW0 T AE
cogumelo|K OW0 G UW M EH L UW
coima|K OW0 Y M AA
coincide|K OW0 S IY D IY
coisa|K OW0 Y Z AA
coitado|K OW0 Y T AE D UW
cola|K AO L AA
colaboração|K OW0 L AE B OW0 R AE S AA W
colar|K OW0 L AE RH
colarinho|K OW0 L AE R IY N IY0 UW
colega|K OW0 L EH G AA
colesterol|K OW0 L EH0 S T EH0 R AO W
colher|K UW L IY EH0 RH
colheres|K OW0 L IY EH R IY SH
colhão|K UW L IY AA W
colo|K AO L UW
colonial|K OW0 L OW0 N Y AE W
colonização|K OW0 L OW0 N IY Z AE S AA W
colégio|K AO L EH ZH Y UW
colônia|K OW0 L OW0 N IY AA
comadre|K UW M AE D R IY
comandar|K OW0 M AA D AE RH
comando|K OW0 M AA D UW
combate|K B AE T IY
combatente|K B AE T T IY
combinar|K B IY N AE RH
combinação|K B IY N AE S AA W
comemorar|K OW0 M EH0 M OW0 R AE RH
comentar|K OW0 M T AE RH
comentário|K OW0 M T AE R Y UW
comercializar|K OW0 M EH0 RH S Y AE L IY Z AE RH
começar|K OW0 M EH0 S AE RH
começo|K AO M EH0 S UW
comichão|K OW0 M IY SH W
comilão|K OW0 M IY L AA W
comintern|K OW0 M T EH RH N IY
comissão|K OW0 M IY S AA W
comité|K OW0 M IY T EH
compacta|K P AE K T AA
compacto|K P AE K T UW
compaixão|K P AE Y SH AA W
companha|K P AA N IY0 AA
companhia|K P AA N IY0 IY AA
comparar|K P AE R AE RH
comparecer|K P AE R EH0 S EH0 RH
compartilhar|K P AE RH T IY L IY AE RH
comparável|K P AE R AE V EH0 W
compasso|K P AE S UW
compatriota|K P AE T R IY AO T AA
compensa|K P S AA
compensai|K P S AE Y
compensam|K P S AA W
compensando|K P S AA D UW
compensara|K P S AE R AA
compensaram|K P S AE R AA W
compensava|K P S AE V AA
compensavam|K P S AE V AA W
compenso|K P S UW
compensou|K P S OW0 W
competente|K P EH0 T T IY
competir|K P EH0 T SH IY RH
competirem|K P EH0 T IY R Y
competitividade|K P EH0 T IY T IY V IY D AE D IY
competitivo|K P EH0 T IY T IY V UW
competição|K P EH0 T SH IY S AA W
compilação|K P IY L AE S AA W
compincha|K P SH AA
completamente|K P L EH T AA M T IY
completar|K P L EH0 T AE RH
completo|K P L EH T UW
complexar|K P L EH0 K IY S AE RH
complexo|K P L EH K S UW
complô|K P L OW0
componente|K P OW0 N T IY
comportamento|K P OW0 RH T AA M T UW
comportar|K P OW0 RH T AE RH
compostura|K P OW0 S T UW R AE
compota|K P AO T AA
compra|K P R AA
comprai|K P R AE Y
comprando|K P R AA D UW
comprara|K P R AE R AA
comprava|K P R AE V AA
compreender|K P R IY D EH0 RH
compreensão|K P R IY S AA W
compressa|K P R EH S AA
comprido|K P R IY D UW
comprimento|K P R IY M T UW
compro|K P R UW
compromete|K P R OW0 M EH T SH IY
compromisso|K P R OW0 M IY S UW
computa|K P UW T AA
computador|K P UW T AE D OW0 RH
computando|K P UW T AA D UW
computara|K P UW T AE R AA
computava|K P UW T AE V AA
computo|K P UW T UW
comu|K OW0 M UW
comuna|K OW0 M UW N AA
comunicado|K UW M UW N IY K AE D UW
comunicar|K OW0 M UW N IY K AE RH
comunicação|K OW0 M UW N IY K AE S AA W
comunidade|K OW0 M UW N IY D AE D IY
comunismo|K OW0 M UW N IY Z M UW
comunista|K OW0 M UW N IY S T AA
comércio|K OW0 M EH RH S Y UW
conceder|K S EH0 D EH0 RH
concentrar|K S T R AE RH
concha|K SH AE
conciliar|K S IY L Y AE R
concitador|K S IY T AE D OW0 RH
concluir|K K L UW IY RH
conclusão|K K L UW Z AA W
concluíram|K K L UW IY R AA W
concorda|K K AO RH D AA
concordar|K K OW0 RH D AE RH
concordância|K K OW0 RH D AA S Y AA
concorrência|K K OW0 RH S Y AA
concreto|K K R EH T UW
condado|K D AE D UW
condefé|K D EH F EH
condensação|K D S AE S AA W
condessa|K D EH0 S AA
condicionado|K D IY S Y OW0 N AE D UW
condigno|K D IY G N UW
condimentar|K D IY M T AE RH
condição|K D IY S AA W
conduzir|K D UW Z IY RH
condução|K D UW S AA W
condão|K D AA W
confederação|K F EH0 D EH0 R AE S AA W
conferir|K F EH0 R IY RH
conferência|K F EH0 R S Y AA
confessa|K F EH S AA
confessar|K F EH0 S AE RH
confiar|K F IY AE RH
configuração|K F IY G UW R AE S AA W
configuro|K F IY G UW R UW
confinar|K F IY N AE R
confirmar|K F IY RH M AE RH
conflito|K F L IY T UW
confortavelmente|K F OW0 RH T AE V EH0 W M T IY
confrade|K F R AE D IY
confraria|K F R AE R IY AA
confrontar|K F RRR T AE RH
confuso|K F UW Z UW
confusão|K F UW Z AA W
confúcio|K F UW S Y UW
congonhinhas|K G OW0 N IY0 IY N IY0 AA S
congratular|K G R AE T UW L AE RH
congratulou|K G R AE T UW L OW0 W
congressista|K G R EH0 S IY S T AA
congresso|K G R EH S UW
congro|K G R UW
conhecer|K OW0 N IY0 EH S EH0 HH
conhecimento|K OW0 N IY0 EH0 S IY M T UW
conjunto|K ZH T UW
conjuro|K ZH UW R UW
conquanto|K K W AA T UW
conquista|K K IY S T AA
conrado|K RH AE D UW
consagrar|K S AE G R AE RH
consciente|K S Y T IY
consciência|K S IY S Y AA
conseguinte|K S EH0 G T IY
conseguir|K S EH G IY HH
conselho|K S EH0 L IY UW
consequência|K S EH0 K W S Y AA
consertar|K S EH0 RH T AE RH
conserto|K S EH T UW
conserva|K S EH RH V AA
consistir|K S IY S T SH IY RH
consta|K S T AA
constante|K S T AA T IY
constantino|K S T AA T IY N UW
constança|K SH T AA S AA
constar|K S T AE RH
constatação|K S T AE T AE S AA W
constituir|K S T SH IY T UW IY RH
constrangimento|K S T RRR AA ZH IY M T UW
construir|K SH T R UW IY HR
construção|K S T R UW S AA W
constância|K SH T AA S Y AA
consulado|K S UW L AE D UW
consular|K S UW L AE RH
consulesa|K S UW L EH0 Z AA
consultar|K S UW W T AE HR
consultório|K S UW W T AO R Y UW
consumidor|K S UW M IY D OW0 RH
consumo|K S UW M UW
conta|K T AA
contactar|K T AE K T AE RH
contagem|K T AE ZH Y
contai|K T AE Y
contam|K T AA W
contando|K T AA D UW
contanto|K T AA T UW
contara|K T AE R AA
contaram|K T AE R AA W
contatar|K T AA T AE RRR
contato|K T AE T UW
contava|K T AE V AA
contavam|K T AE V AA W
contenda|K T D AA
contente|K T T IY
conter|K T EH0 RH
contexto|K T EH0 S T UW
conteúdo|K T EH0 UW D UW
contingenciamento|K T ZH S Y AE M T UW
contino|K T IY N UW
continua|K T IY N UW AA
continuamente|K T IY N UW AE M T IY
continuando|K T IY N W AA D UW
continuar|K T IY N UW AE RH
conto|K T UW
contou|K T OW0 W
contra|K T R AA
contramestra|K T R AE M EH SH T R AE
contramestre|K T R AE M EH SH T R IY
contramão|K T R AE M AA W
contraste|K T R AE S T SH IY
contrato|K T R AE T UW
contribuir|K T R IY B UW IY RH
contribuição|K T R IY B UW Y S AA W
control|K T R OW0 W
controlar|K T R OW0 L AE RH
controle|K T R AO L IY
controlo|K T R AO L UW
contumaz|K T UW M AE S
contínuo|K T IY N W UW
convencer|K V S EH0 RH
convenção|K V S AA W
conversa|K V EH RH S AA
conversar|K V EH0 RH S AE RH
converter|K V EH0 RH T EH0 RH
convexo|K V EH K S UW
convés|K V EH S
cookie|K UW K IY
cooptar|K OW0 OW0 P T AE RH
copa|K AO P AA
copeiro|K OW0 P EH0 Y R UW
copo|K AO P UW
copta|K AO P T AA
coquete|K OW0 K EH T SH IY
coragem|K OW0 R AE ZH Y
coraçãozinho|K OW0 R AE S AA W Z IY N IY0 UW
corbélia|K OW0 RH B EH L IY AA
corcunda|K AO HH K D AE
core|K AO R IY
cores|K AO R IY S
corintiano|K OW0 R T SH IY AA N UW
cornalina|K OW0 R N AA L IY N AA
cornélio|K OW0 RH N EH L Y UW
coro|K AO R UW
coronariano|K OW0 R OW0 N AE R IY N UW
coronavírus|K OW0 R OW0 N AE V IY R UW S
corrida|K OW0 RH IY D AA
corroboração|K OW0 RH OW0 B OW0 R AE S AA W
corrupio|K UW RH UW P IY UW
corruptela|K OW0 RH UW P T EH L AA
corrupto|K OW0 RH UW P T UW
corrupção|K OW0 HH UW P IY S AA W
corréu|K OW0 RH EH W
cortiça|K OW0 RH T IY S AA
cortiço|K OW0 RH T IY S UW
coruchéu|K OW0 R UW SH EH W
coró|K OW0 R AO
cos|K UW S
coser|K UW Z EH0 RRR
cospe|K AO SH P IY
cossaco|K OW0 S AE K UW
costa|K AO S T AA
costume|K UW S T UW M IY
cota|K AO T AA
cotiano|K OW0 T SH IY AA N UW
cotovia|K OW0 T OW0 V IY AA
cotão|K OW0 T AA W
coulrofobia|K OW0 W HH OW0 F OW0 B IY AA
country|K AE W T R IY
couro|K OW0 W R UW
cousa|K OW0 W Z AA
couto|K OW0 W T UW
coveiro|K OW0 V EH0 Y R UH
covo|K OW0 V UW
coxa|K OW0 SH AA
coxim|K OW0 SH
coxo|K OW0 SH UW
cozido|K UW Z IY D UW
cozinhando|K OW0 Z IY N IY0 AA D UW
cozinhar|K OW0 Z IY N IY0 AE RH
crasso|K R AE S UW
cratera|K R AE T EH R AA
crau|K R AE W
crava|K R AE V AA
cravejado|K R AE V EH0 ZH AE D UH
cravo|K R AE V UW
credo|K R EH D UW
credor|K R EH0 D OW0 R
credulidade|K R EH D UW L IY D AE D IY
crença|K R S AA
creolina|K R EH0 W L IY N AA
crepe|K R EH P IY
crepes|K R EH P IY SH
crescer|K R EH0 S EH0 RH
crescimento|K R EH0 S IY M T UW
creta|K R EH T AA
cretino|K R EH0 T IY N UW
creu|K R EH0 W
cri|K R IY
cria|K R IY AA
criada|K R IY AE D AA
criadora|K R IY AE D OW0 R AA
criança|K R IY AA S AA
crianças|K R IY AA S AA S
criar|K R IY AE RH
criativo|K R IY AE T IY V UW
criatura|K R IY AE T UW R AA
crica|K R IY K AE
cricri|K R IY K R IY
crime|K RRR IY M IY
crio|K R IY UW
criptido|K R IY P T SH IY D OW0
criptobiose|K R IY P T OW0 B IY AO Z IY
criptobiótico|K R IY P T OW0 B IY AO T SH IY K UW
criptococose|K R IY P T OW0 K OW0 K AO Z IY
criptocomunismo|K R IY P K OW0 M UW N IY S M UW
criptocomunista|K R IY P K OW0 M UW N IY S T AE
criptofascismo|K R IY P T OW0 F AE S IY S M UW
criptofascista|K R IY P T OW0 F AE S IY S T AE
criptofone|K R IY P T OW0 F OW0 N IY
criptoftalmia|K R IY P T OW0 F T AE W M IY AE
criptoftalmo|K R IY P T OW0 F T AE W M UW
criptografia|K R IY P T OW0 G R AE F IY AE
criptograma|K R IY P T OW0 G R AA M AE
criptogâmico|K R IY P G AA M IY K UW
criptologia|K R IY P T OW0 L OW0 ZH IY AE
criptológico|K R IY P T OW0 L AO ZH IY K UW
criptomnésia|K R IY P T OW0 M N EH Z Y AE
criptomnésico|K R IY P T OW0 M N EH Z IY K UW
criptomoeda|K R IY P T OW0 M UW EH D AE
criptorquia|K R IY P T OW0 RH K IY AE
criptoscopia|K R IY P T OW0 SH K OW0 P IY AE
criptossistema|K R IY P S IY S T EH0 M AE
criptoxantina|K R IY P T OW0 SH T SH IY N AE
criptozoologia|K R IY P T OW0 Z OW0 OW0 L OW0 ZH IY AE
criptozoólogo|K R IY P T OW0 Z OW0 AO L OW0 G UW
criptídeo|K R IY P T SH IY D ZH IY UW
criptógama|K R IY P T AO G AA M AE
criptógrafo|K R IY P T AO G R AE F UW
criptósporo|K R IY P T AO SH P OW0 R UW
crise|K R IY Z IY
crisma|K R IY Z M AA
crisol|K R IY Z AO W
crispada|K R IY S P AE D AA
crispado|K R IY S P AE D UW
crispar|K R IY S P AE RH
cristandade|K R IY S T AA D AE D IY
cristianismo|K RRR IY S T Y AA N IY Z M UW
cristiano|K R IY S T Y AA N UW
cristo|K R IY S T UW
cristóvão|K R IY S T AO V AA W
criticar|K R IY T IY K AE RH
crocante|K R OW0 K AA T IY
crocodilo|K R OW0 K OW0 D IY L UW
croquete|K R OW0 K EH T SH IY
crossa|K R AO S AA
cru|K R UW
crush|K R AA SH
cruzada|K R UW Z AE D AA
cruzar|K R UW Z AE RH
cruzeta|K R UW Z EH0 T AA
cruzmaltina|K R UW Z M AE W T IY N AA
crápula|K R AE P UW L AE
crédito|K R EH D ZH IY T UW
créu|K R EH W
crê|K R EH0
crítica|K R IY T SH IY K AA
crítico|K R IY T SH IY K UW
cu|K UW
cubicar|K UW B IY K AE RH
cuca|K UW K AA
cuecas|K W EH K AA S
cuia|K UW Y AA
cuidadinho|K UW Y D AE D IY N IY0 UW
cuidado|K UW Y D AE D UW
cuidadoso|K UW Y D AE D OW0 Z UW
cuidar|K UW Y D AE RH
cujo|K UW ZH UW
culinária|K UW L IY N AE R Y AE
culminar|K UW W M IY N AE RH
culpa|K UW W P AA
culpar|K UW W P AE RH
culposamente|K UW W P OW0 Z AE M T IY
cult|K UW W T
cultivo|K UW W T IY V UW
culto|K UW W T UW
cultura|K UW W T UW R AA
cumprir|K P R IY RH
cuneiforme|K UW N EH0 Y F AO M EH0
cuneta|K UW N EH0 T AE
cupim|K UW P
cupincha|K UW P SH AA
cupom|K UW P
cupuaçuzeiro|K UW P UW AE S UW Z EH0 Y R UW
cupão|K UW P AA W
curador|K UW R AE D OW0 RH
curação|K UW R AE S AA W
curcuma|K UW RH K UW M AA
curdistão|K UW RH D IY S T AA W
curdo|K UW RH D UW
curimã|K UW R IY M AA
curinga|K UW R G AA
curiosidade|K UW R Y OW0 Z IY D AE D IY
curiúva|K UW R IY UW V AA
curo|K UW R UW
curto|K UW RH T UW
curupira|K UW R UW P IY R AA
cus|K UW S
custar|K UW S T AE RH
cutcharra|K UW T AE HR AE
cutelo|K UW T EH L UW
cuti|K UW T IY
cuzão|K UW Z AA W
cá|K AE
cáqui|K AE K IY
cárie|K AE R Y EH0
cárpatos|K AE RH P AE T UW S
câmbio|K AA B Y UW
câncer|K AA S EH0 RH
cã|K AA
cãibra|K AA Y B R AA
cão|K AA W
célebre|S EH L EH0 B R IY
célula|S EH L UW L AA
cérebro|S EH R EH0 B R UW
céu|S EH W
cê|S EH0
cíclico|S IY K L IY K UW
cível|S IY V IY W
cóccix|K AO K S IY S
códice|K AO D IY S IY
código|K AO D IY G UW
cólera|K AO L EH0 R AA
cópia|K AO P Y AA
cópula|K AO P UW L AA
córrego|K AO RH EH0 G UW
córsico|K AO RH S IY K UW
córtex|K AO RH T EH0 K S
cômpito|K P IY T UW
cônscio|K S IY UW
côvão|K OW0 V AA W
cúmplice|K P L IY S IY
cúrcuma|K UW RH K UW M AA
dagmar|D AE G M AE RH
dai|D AE Y
daiane|D AE Y AA N IY
dakar|D AE K AE RH
dali|D AE L IY
dall'agnol|D AE L AA N IY0 AO W
damasco|D AE M AE S K UW
danado|D AA N AE D UW
dando|D AA D UW
daniel|D AA N Y EH W
danificar|D AA N IY F IY K AE RH
dano|D AA N UW
dantas|D AA T AA S
dante|D AA T IY
dança|D AA S AA
danço|D AA S UW
daora|D AE AO R AA
daquela|D AE K EH L AA
daquelas|D AE K EH L AA S
daquele|D AE K EH0 L IY
daqueles|D AE K EH0 L IY S
daqui|D AE K IY
daquilo|D AE K IY L UW
darknet|D AE RH K N EH T
darwin|D AE RH V
data|D AE T AA
datashow|D AE T AE SH OW0 W
datiloscopia|D AE T IY L OW0 SH K OW0 P IY AA
dava|D AE V AA
davam|D AE V AA W
davi|D AE V IY
david|D EH0 Y V IY D IY
daí|D AE IY
deadlock|D EH D IY L AO K IY
debate|D EH0 B AE T SH IY
debelar|D EH0 B EH0 L AE HR
debruçar|D EH0 B R UW S AE RH
debuxar|D EH0 B UW SH AE RH
decadência|D EH0 K AE D S Y AA
decidir|D EH0 S IY D IY RH
decisiva|D EH0 S IY Z IY V AA
decisão|D EH0 S IY Z AA W
declarar|D EH0 K L AE R AE RH
declaração|D EH0 K L AE R AE S AA W
declinativas|D EH0 K L IY N AE T IY V AA S
declinativo|D EH0 K L IY N AE T IY V UW
declive|D EH0 K L IY V IY
decolagem|D EH0 K OW0 L AE ZH Y
decorar|D EH0 K OW0 R AE R
dedetização|D EH0 D EH0 T SH IY Z AE S AA W
dedicar|D EH0 D IY K AE RH
dedicava|D EH0 D IY K AE V AA
deduro|D EH0 D UW R UW
def|D EH F
defender|D EH0 F D EH0 RH
defensiva|D EH0 F S IY V AA
defensável|D EH0 F S AE V EH0 W
deficiente|D EH0 F IY S Y T IY
deficitário|D EH0 F IY S IY T AE RRR Y UW
definir|D EH0 F IY N IY RH
definitiva|D EH0 F IY N IY T IY V AA
definitivas|D EH0 F IY N IY T IY V AA S
definitivo|D EH0 F IY N IY T IY V UW
definitivos|D EH0 F IY N IY T IY V UW S
deflagração|D EH0 F L AE G R AE S AA W
deformação|D EH0 F OW0 RH M AE S AA W
defunto|D IY F T UW
degelo|D EH0 ZH EH0 L UW
degradê|D EH0 G R AE D EH0
deia|D EH Y AA
deificação|D EH0 IY F IY K AE S AA W
deitado|D EH0 Y T AE D UW
deitar|D EH0 Y T AE HR
deiviane|D EH0 Y V Y AA N IY
dela|D EH L AA
delas|D EH L AA S
delaware|D EH0 L AE W EH RH
delay|D EH0 L EH0 Y
dele|D EH0 L IY
delegacia|D EH0 L EH0 G AE S IY AA
deles|D EH0 L IY S
delete|D L EH T SH IY
delgada|D EH0 W G AE D AA
delgado|D EH0 W G AE D UW
deli|D EH L IY
delicado|D EH0 L IY K AE D UW
delito|D EH0 L IY T UW
delivery|D EH0 L IY V EH0 R IY
demanda|D EH0 M AA D AA
demandar|D EH0 M AA D AE RH
demissexual|D EH0 M IY S EH0 K S UW AE W
democracia|D EH0 M OW0 K R AE S IY AA
democrático|D EH0 M OW0 K R AE T SH IY K UW
demográfico|D EH0 M OW0 G R AE F IY K UW
demonstrar|D EH0 M S T R AE RH
demorar|D EH0 M OW0 R AE RH
demétrio|D EH0 M EH T R IY UW
dendê|D D EH0
dengo|D G UW
denguice|D G IY S IY
denso|D S UW
dentada|D T AE D AA
dentadura|D T AE D UW R AA
dentista|D T IY S T AE
dentre|D T R IY
dentro|D T R UW
denunciar|D EH0 N S IY AE RH
deodato|D EH0 W D AE T UW
departamento|D EH0 P AE RH T AE M T UW
depender|D EH0 P D EH0 RH
dependurada|D EH0 P D UW R AE D AA
depilação|D EH0 P IY L AE S AA W
depois|D EH0 P OW0 Y S
deprecar|D EH0 P R EH0 K AE HR
depreciativo|D EH0 P R EH0 S Y AE T SH IY V UW
deprê|D EH0 P R EH0
deputado|D EH0 P UW T AE D UW
deque|D EH K IY
dera|D EH R AA
deram|D EH R AA W
derivada|D EH0 R IY V AE D AE
derradeira|D EH0 RH AE D EH0 Y R AA
derradeiro|D EH0 RH AE D EH0 Y R UW
derramamento|D EH0 HR AE M AE M T UW
derramar|D EH0 RH AA M AE RH
derrete|D EH0 RH EH T SH IY
derrocar|D EH0 RH OW0 K AE RH
desacato|D EH0 Z AE K AE T UW
desacompanhei|D EH0 Z AE K P AA N IY0 EH0 Y
desafiar|D EH0 Z AE F IY AE RH
desafinado|D ZH IY Z AE F IY N AE D UW
desaforamento|D ZH IY Z AE F OW0 R AE M T UW
desaforar|D ZH IY Z AE F OW0 R AE HR
desaforo|D ZH IY Z AE F AO R UW
desafortunada|D EH0 Z AE F OW0 RH T UW N AE D AA
desalojado|D IY Z AE L OW0 ZH AE D UW
desamparada|D EH0 Z AA P AE R AE D AA
desamparar|D EH0 Z AA P AE R AE RH
desaparecer|D EH0 Z AE P AE R EH0 S EH0 RH
desapercebido|D ZH IY Z AE P EH0 R S EH0 B IY D UW
desaprender|D EH0 Z AE P R D EH0 RH
desarmamentista|D ZH IY Z AE R M AE M T SH IY S T AE
desbocado|D IY S B OW0 K AE D UW
descaem|D EH0 SH K AE Y
descansar|D EH0 S K AA S AE RH
descanso|D IY S K AA S UW
descaroçado|K AE R OW0 S UW D UW
descarrilamento|D EH0 S K AE RH IY L AE M T UW
descarte|D IY S K AE RH T IY
descartes|D IY S K AE RH T IY S
descartável|D EH0 SH K AE HR T AE V EH W
descer|D EH0 S EH0 RH
descida|D EH0 S IY D AA
descobrir|D EH0 S K OW0 B R IY RH
desconexo|D ZH IY Y SH K OW0 N EH K S UW
desconhecido|D IY S K OW0 N IY0 EH0 S IY D UW
desconversar|D EH0 S K V EH0 RH S AE RH
descortinar|D EH0 S K OW0 R T IY N AE R
descrever|D EH0 S K R EH0 V EH0 RH
descrita|D IY S K R IY T AA
descrito|D EH0 S K R IY T UW
descrição|D EH0 S K R IY S AA W
desculpa|D IY SH K UW W P AA
desculpar|D IY S K UW W P AE RH
desdenhar|D EH0 Z D EH0 N IY0 AE RH
desdenhoso|D EH0 Z D EH0 N IY0 OW0 Z UW
desdo|D EH0 Y Z D UW
deseducado|D ZH IY Z EH0 D UW K AE D UW
desejar|D EH0 Z EH0 ZH AE HR
desejo|D EH0 Z EH0 ZH UW
desejoso|D EH0 Z EH0 ZH OW0 Z UW
desempenho|D EH0 Z P EH0 N IY0 UW
desemprego|D EH0 Z P R EH0 G UW
desencadear|D EH0 Z K AE D IY AE RH
desenhar|D EH0 Z EH0 N IY0 AE RH
desenhista|D EH0 Z EH0 N IY0 IY SH T AA
desenho|D EH0 Z EH0 N IY0 UW
desenraizar|D EH0 Z RH AE IY Z AE R
desenrugar|D EH0 Z Y RH UW G AE RH
desentendimento|D EH0 Z T D ZH IY M T UW
desenvencilhar|D EH0 S V S IY L IY AE HR
desenvincilhar|D EH0 S V S IY L IY AE HR
desenvolver|D ZH IY Z V OW0 W V EH0 RH
desenvolveu|D EH0 Z V OW0 W V EH W
desenvolvido|D EH0 Z V OW0 W V IY D UW
desenvolvimento|D IY Z V OW0 W V IY M T UW
desequilibrou|D EH0 Z EH0 K IY L IY B R OW0 W
desertificar|D EH0 Z EH0 RH T IY F IY K AE RH
desfazimento|D ZH IY S F AE Z IY M T UW
desfecho|D ZH IY S F EH0 SH UW
desgastar|D EH0 Z G AE S T AE RH
desgraça|D IY SH G R AE S AA
desgraçar|D IY Z G RRR AE S AE HR
desgraço|D IY Z G RRR AE S UW
desidratação|D EH0 Z IY D R AE T AE S AA W
designadamente|D EH0 Z IY G IY N AE D AE M T IY
designado|D EH0 Z IY G IY N AE D UW
desinteresse|D EH0 Z T EH0 R EH S IY
desistir|D EH0 Z IY S T IY RH
desjejua|D EH0 S ZH EH0 ZH UW AE
desligado|D ZH IY ZH L IY G AE D UW
desligar|D IY S L IY G AE RH
deslocar|D ZH IY S L OW0 K AE RH
deslocação|D EH0 Z L OW0 K AE S AA W
desnivelado|D EH0 Z N IY V EH0 L AE D UW
desolar|D EH0 Z OW0 L AE HR
desolação|D EH0 Z OW0 L AE S AA W
desonerar|D EH0 Z OW0 N EH0 R AE RH
desonra|D IY Z RH AA
despedido|D EH0 S P EH0 D IY D UW
despedir|D EH0 S P EH0 D IY RH
despender|D EH0 S P D EH0 RH
despenhadeiro|D EH0 S P EH0 N IY0 AE D EH0 Y R UW
desperdiçar|D ZH IY S P EH0 RH D ZH IY S AE RH
desperdício|D ZH IY S P EH0 RH D ZH IY S Y UW
despesa|D ZH IY S P EH0 Z AA
despir|D IY S P IY RH
despiu|D IY S P IY W
desprezo|D EH0 S P R EH Z UW
desprezível|D EH0 S P R EH0 Z IY V EH0 W
desqualificar|D EH0 S K W AE L IY F IY K AE RH
desrespeito|D EH0 ZH RH EH0 SH P EH0 Y T UW
desrespeitoso|D EH0 ZH RH EH0 SH P EH0 Y T OW0 Z UW
dessa|D EH S AA
dessas|D EH S AA S
desta|D EH S T AA
destacamento|D EH0 S T AE K AE M T UW
destacar|D ZH IY SH T AE K AE R
destas|D EH S T AA S
deste|D EH0 S T IY
desterro|D EH0 SH T EH0 RH UW
destes|D EH0 S T IY S
destino|D EH0 S T SH N UW
destras|D EH S T R AA S
destreza|D EH0 S T R EH0 Z AA
destruir|D EH0 S T R UW IY RH
destruído|D IY SH T R UW IY D UW
desuso|D EH0 Z UW Z UW
desvencilhar|D EH0 S V S IY L IY AE HR
desvio|D IY SH V IY UW
desânimo|D EH0 Z AA N IY M UW
desídia|D EH0 Z IY D ZH Y AE
desígnio|D EH0 Z IY G N Y UW
detalhe|D EH0 T AE L IY IY
detectar|D EH0 T EH0 K T AE RH
deterioração|D EH0 T EH0 R IY OW0 R AE S AA W
determinado|D EH0 T EH0 R M IY N AE D UW
determinar|D EH0 T EH0 RH M IY N AE RH
detonado|D EH0 T OW0 N AE D UW
detran|D EH0 T R AA
detroit|D EH0 T R AO Y T
deturpação|D EH0 T UW RH P AE S AA W
deu|D EH0 W
deusa|D EH0 W Z AA
devagar|D ZH IY V AE G AE RH
devassa|D EH0 V AE S AA
devasso|D EH0 V AE S UW
deve|D EH V IY
dever|D EH0 V EH0 RH
deveras|D EH0 V EH R AA S
devia|D IY V IY AA
devolver|D EH0 V OW0 W V EH0 RH
devorar|D EH0 V OW0 R AE HR
devoção|D EH0 V OW0 S AA W
dexter|D EH K S T EH0 RH
dezembro|D EH Z B R UW
dezena|D EH0 Z N AA
dezoito|D IY Z OW0 Y T UW
deísta|D EH0 IY S T AA
diabete|D ZH IY AE B EH T SH IY
diabo|D Y AE B UW
diabos|D Y AE B UW S
diarista|D Y AE R IY S T AA
diazinho|D IY AA Z N IY0 UW
dica|D IY K AA
dicionário|D IY S Y OW0 N AE R Y UW
diesel|D IY Z EH0 W
diet|D AE Y T
diferente|D IY F EH0 R T IY
diferença|D IY F EH0 R S AA
diferir|D IY F EH0 R IY RH
dificuldade|D IY F IY K UW W D AE D IY
difuso|D IY F UW Z UW
difícil|D IY F IY S IY W
digam|D IY G AA W
digitar|D IY ZH IY T AE RH
dignificar|D IY G IY N IY F IY K AE RH
digno|D IY G N UW
dimensão|D IY M S AA W
diminuir|D IY M IY N UW IY RH
dindim|D ZH D ZH
dinheirinho|D IY N IY0 EH0 Y R IY N IY0 UW
dino|D IY N UW
dinossauro|D IY N AO S AE W R UW
diploma|D ZH IY P L OW0 M AA
diplomática|D IY P L OW0 M AE T IY K AA
diplomático|D IY P L OW0 M AE T IY K UW
diretor|D IY R EH0 T OW0 RH
dirigir|D IY R IY ZH IY HR
dirigível|D IY R IY ZH IY V EH0 W
discente|D ZH IY S T SH IY
discernimento|D IY S EH0 RH N IY M T UW
disciplina|D ZH IY S IY P L IY N AA
discipline|D IY S IY P L IY N IY
discretamente|D IY S K R EH T AA M T IY
discurso|D IY S K UW RH S UW
discussão|D ZH IY S K UW S AA W
discutir|D IY S K UW T IY RH
disenteria|D IY Z T EH0 R IY AA
disgeusia|D IY S ZH EH0 W Z IY AE
disponível|D IY S P OW0 N IY V EH0 W
disposto|D IY S P OW0 S T UW
dissipar|D IY S IY P AE RH
disso|D IY S UW
dissociável|D ZH IY S OW0 S IY AE V EH0 W
dissonância|D ZH IY S OW0 N AA S Y AE
distantes|D IY SH T AA T IY SH
distinguir|D ZH IY S T SH G W IY RH
distinta|D IY S T T AA
distintas|D IY S T T AA S
distinto|D IY S T T UW
distintos|D IY S T T UW S
distinção|D IY SH T S AA W
distorção|D IY S T OW0 RH S AA W
distração|D IY S T R AE S AA W
distribuição|D ZH IY S T R IY B UW Y S AA W
distrito|D IY SH T R IY T UW
distância|D ZH IY S T AA S Y AA
distúrbio|D IY S T UW RH B Y UW
dita|D ZH IY T AA
ditado|D IY T AE D UW
ditadura|D IY T AE D UW R AE
ditatorial|D IY T AE T OW0 R Y AE W
diurese|D ZH IY UW R EH Z IY
diurna|D IY UW RH N AA
diurnas|D IY UW RH N AA S
diurno|D IY UW RH N UW
diurnos|D IY UW RH N UW S
diva|D IY V AE
diversão|D IY V EH0 RH S AA W
divertimento|D ZH IY V EH0 HH T SH IY M T UW
dividir|D IY V IY D IY RH
divindade|D IY V D AE D IY
divisão|D ZH IY V IY Z AA W
diáspora|D IY AE S P OW0 R AA
dj|D IY D EH0 Y
dmitri|D M IY T R IY
do|D UW
dobra|D AO B R AA
dobras|D AO B R AA S
dobro|D AO B R UW
dobrão|D OW0 B R AA W
doca|D AO K AA
doceria|D OW0 S EH0 R IY AE
documental|D OW0 K UW M T AE W
documentar|D OW0 K UW M T AE RH
documento|D OW0 K UW M T UW
dodecaedro|D OW0 D EH0 K AE EH D R UW
dodecaneso|D OW0 D EH0 K AA N EH0 Z UW
doe|D OW0 IY
doença|D OW0 S AA
doenças|D UW S AA S
doer|D OW0 EH0 RH
dog|D AO G IY
dogma|D AO G M AA
dogão|D AO G AA W
doleiro|D OW0 L EH0 Y R UW
dolores|D OW0 L OW0 R IY S
dolorida|D OW0 L OW0 R IY D AA
doloroso|D OW0 L OW0 R OW0 Z UW
dom|D
domina|D OW0 M IY N AA
dominada|D OW0 M IY N AE D AA
dominatrix|D OW0 M IY N AE T RRR IY K S
dominatrixes|D OW0 M IY N AE T RRR IY K S IY S
domingueiro|D OW0 M G EH0 Y R UW
dominó|D OW0 M IY N AO
donbass|D B AE S
donizete|D OW0 N IY Z EH T IY
dono|D OW0 N UW
donut|D AA N AA T
donzela|D Z EH L AA
dorido|D OW0 R IY D UW
dormente|D OW0 RH M T IY
dormir|D OW0 RH M IY RH
doroteia|D OW0 R OW0 T EH Y AA
dorzinha|D OW0 RH Z IY N IY0 AA
dossiê|D OW0 S IY EH0
dou|D OW0 W
douglas|D OW0 W G L AA S
dourado|D OW0 W R AE D UW
douro|D OW0 W R UW
doutor|D OW0 W T OW0 RH
doutorzinho|D OW0 W T OW0 RH Z IY N IY0 UW
doutrinação|D OW0 T R IY N AE S AA W
doutro|D OW0 W T R UW
dover|D OW0 V EH0 RH
download|D AE W L OW0 W D
doçura|D OW0 S UW R AE
doído|D UW IY D UW
dresdem|D R EH Z D Y
drinque|D R K IY
drive|D R AE Y V IY
driver|D R AE Y V EH0 RH
droga|D R AO G AA
drogaria|D R OW0 G AE R IY AA
dropar|D R OW0 P AE RH
drusa|D R UW Z AA
drácula|D R AE K UW L AA
dubai|D UW B AE Y
dublim|D AA B L
ducto|D UW K T UW
dum|D
duma|D UW M AA
dumas|D UW M AA S
duna|D UW N AA
duns|D S
duplo|D UW P L UW
duquesa|D UW K EH0 Z AA
durar|D UW R AE RH
durazzo|D UW R AE T S UW
durban|D UW RH B AA
durex|D UW RRR EH K S
durio|D UW R IY UW
duro|D UW R UW
duríssimo|D UW R IY S IY M UW
duto|D UW T UW
duunvirato|D UW V IY R AE T UW
duvidar|D UW V IY D AE RH
dá|D AE
dão|D AA W
débito|D EH B IY T UW
década|D EH K AA D AA
décimo|D EH S IY M UW
déficit|D EH F IY S IY T
dê|D EH0
dêixis|D EH0 Y K S IY SH
díspar|D IY S P AE RH
dó|D AO
dúvida|D UW V IY D AA
e|EH
ebó|EH0 B AO
eclipse|EH0 K L IY P S IY
eco|EH K UW
ecografia|EH K OW0 G R AE F IY AA
economia|EH0 K OW0 N OW0 M IY AA
economista|EH0 K OW0 N OW0 M IY S T AA
econômico|EH0 K OW0 N OW0 M IY K UW
ecrã|EH K R AA
eczema|EH0 G Z EH0 M AA
edgar|EH D G AE RH
edificar|EH0 D IY F IY K AE RH
edifício|EH0 D ZH IY F IY S Y UW
editor|EH0 D IY T OW0 RH
editorial|EH0 D IY T OW0 R IY AE W
edna|EH D N AA
edredom|EH0 D R EH0 D
eduardo|EH0 D W AE RH D UW
educacional|EH0 D UW K AE S Y OW0 N AE W
eficaz|EH0 F IY K AE Y S
egoísta|EH0 G OW0 IY SH T AA
egídio|EH0 ZH IY D Y UW
egípcio|EH0 ZH IY P S Y UW
einstein|AE Y S T AE Y
ela|EH L AA
elegível|EH0 L EH0 ZH IY V EH0 W
elemento|EH0 L EH0 M T UW
elevado|EH0 L EH0 V AE D UW
elevar|EH0 L EH0 V AE RH
eliminar|EH0 L IY M IY N AE RH
eliminação|IY L IY M IY N AE S AA W
elisabete|EH0 L IY Z AE B EH T IY
elmo|EH W M UW
elo|EH L UW
eloá|EH0 L OW0 AE
elucubrar|EH0 L UW K UW B RRR AE R
elucubração|EH0 L UW K UW B R AE S AA W
elástico|EH0 L AE S T IY K UW
em|Y
emagrecer|IY M AE G R EH0 S EH0 RH
emascular|EH0 M AE S K UW L AE RH
embaixada|B AE Y SH AE D AA
embaixo|B AE Y SH UW
embalagem|B AE L AE ZH Y
embargo|B AE RH G UW
embolar|B OW0 L AE HR
embora|B AO R AA
embromation|B R OW0 M EH0 Y SH
embrulho|B R UW L IY UW
emburrecer|B UW RH EH0 S EH0 HR
emburrecimento|B UW RH EH0 S IY M T UW
ementa|EH0 M T AA
emergir|EH0 M EH0 RH ZH IY RH
emigrar|IY M IY G R AE R
emir|EH0 M IY RH
emissora|EH0 M IY S OW0 R AA
emos|EH0 M UW S
emoção|EH M AO S AA W
empedernido|P EH0 D EH0 RH N IY D UW
empedernidos|P EH0 D EH0 RH N IY D UW S
empedernir|P EH0 D EH0 RH N IY RH
empolado|M P OW0 L AE D UW
empregar|P R EH0 G AE RH
emprego|P R EH G UW
empresa|P R EH0 Z AA
emprestar|P R EH0 S T AE RH
empréstimo|P R EH S T IY M UW
empunhar|P UW Y AE R
empurrar|P UW RH AE RH
empáfia|P AE F Y AA
empório|P AO R Y UW
emulação|EH0 M UW L AE S AA W
emílio|EH0 M IY L Y UW
encafifar|K AE F IY F AE R
encaixar|K AE Y SH AE RH
encalistrar|K AE L IY S T R AE R
encantar|K AA T AE RH
encantação|K AA T AE S AA W
encanto|K AA T UW
encarnado|K AE RH N AE D UW
encaroçado|K AE R OW0 S AE D UW
encavacar|K AE V AE K AE R
encefalograma|S EH F AE L OW0 G R AA M AA
encenação|S EH0 N AE S AA W
encharcado|SH AA R K AE D UW
encher|SH EH0 RH
enciclopédia|S IY K L OW0 P EH D IY AE
encomenda|K OW0 M D AA
encontrar|K T R AE RH
encontro|K T R UW
encorajar|K R AE ZH AE RH
encravar|K R AE V AE RH
encravou|K R AE V OW0 W
endereço|D EH0 R EH0 S OW0
endomingado|D UW M G AE D UW
endoscopia|D OW0 SH K OW0 P IY AE
energia|EH0 N EH0 RH ZH IY AA
enfardassem|F AE RH D AE S Y
enfeitar|F EH0 Y T AE RH
enfermaria|Y F EH0 RH M AE R IY AA
enfiteuse|F IY T EH0 W Z IY
enfitêutico|F IY T EH0 W T IY K UW
enfrentar|F R T AE RH
enganar|G AA N AE RH
enganoso|G AA N OW0 Z UW
engavete|G AE V EH T SH IY
engenheiro|ZH EH0 N IY0 EH0 Y R UW
engolir|G OW0 L IY RH
engorgitamento|G OW0 RH ZH IY T AE M T UW
engorgitamentos|G OW0 RH ZH IY T AE M T UW S
engorovinhado|G OW0 R OW0 V IY N IY0 AE D UW
engraçadinho|G R AE S AE D IY N IY0 UW
engruvinhado|G R UW V IY N IY0 AE D UW
enguia|G IY AA
enjoo|Y ZH OW0 UW
enlevo|EH0 Y L EH0 V UW
enojar|EH0 N OW0 ZH AE R
enorme|EH0 N AO RH M IY
enormemente|EH0 N AO RH M IY M T IY
enquadrar|Y K W AE D R AE R
enquanto|K W AA T UW
enraizar|RH AE IY Z AE RH
enredo|RH EH D UW
enrugar|Y RH UW G AE RH
ensinamento|S IY N AE M T UW
ensinar|S IY N AE RH
ensino|S IY N UW
entalhe|T AE L IY IY
enteado|T IY AE D UW
entediar|T EH0 D IY AE R
entendimento|T D IY M T UW
entra|T R AA
entrada|T R AE D AA
entrado|T R AE D UW
entrando|T R AA D UW
entrar|T R AE HR
entrava|T R AE V AA
entregador|T R EH0 G AE D OW0 HR
entregar|T R EH0 G AE RH
entremeio|T R EH0 M EH0 IY UW
entretenimento|T R EH0 T EH0 N IY M T UW
entro|T R UW
entrou|T R OW0 W
entulhado|T UW L IY AE D UW
entusiasmo|T UW Z IY AE Z M UW
entusiasta|T UW Z IY AE SH T AA
entusiasticamente|T UW Z IY AE S T IY K AA M T IY
entusiástico|T UW Z IY AE S T IY K UW
enumeração|EH0 N UW M EH0 R AE S AA W
envelope|V EH0 L AO P IY
envencilhar|V S IY L IY AE HR
enviar|V IY AE RH
envolver|V OW0 W V EH0
envólucro|V AO L UW K R UW
enxofre|EH0 N SH AO F R IH
enxágue|SH AE G W IY
enzímico|Z IY M IY K UW
enérgica|EH0 N EH RH ZH IY K AA
enérgico|EH0 N EH RH ZH IY K UW
eoceno|EH0 OW0 S EH0 N UW
eoo|EH0 AO UW
epigenesia|EH0 P IY ZH EH0 N EH0 Z IY AE
epigenia|EH0 P IY ZH EH0 N IY AE
epilepsia|EH0 P IY L EH0 P S IY AA
epopeia|EH0 P OW0 P EH Y AA
epíscopo|EH0 P IY S K OW0 P UW
equidade|EH0 K W IY D AE D IY
equilibra|EH0 K IY L IY B R AA
equilíbrio|EH0 K IY L IY B R Y UW
equino|EH0 K W IY N UW
equinócio|EH0 K IY N AO S Y UH
equipamento|EH0 K IY P AE M T UW
equipar|EH0 K IY P AE RH
equivalente|EH0 K IY V AE L T IY
equivocou|EH0 K IY V OW0 K OW0 W
era|EH R AA
eram|EH R AA W
erevan|EH0 R EH0 V AA
erguer|EH0 RH G EH0 RH
erradicar|EH0 RH AE D IY K AE RH
errado|EH0 RH AE D UW
errar|EH AE HH
esboçar|EH0 Z B OW0 S AE RH
escachar|EH0 S K AE SH AE RH
escadaria|IY SH K AE D AE R IY AA
escala|IY S K AE L AA
escalar|IY S K AE L AE RH
escancarar|IY SH K AA K AE R AE R
escandinávia|EH0 S K AA D IY N AE V Y AA
escapar|IY S K AE P AE RH
escassez|EH0 S K AE S EH0 S
escatológica|EH0 S K AE T OW0 L AO ZH IY K AA
esclarecedora|EH0 S K L AE R EH0 S EH0 D OW0 R AA
esclarecer|IY S K L AE R EH0 S EH0 RH
escocesa|EH0 S K OW0 S EH0 Z AA
escocesas|EH0 S K OW0 S EH0 Z AA S
escoceses|EH0 S K OW0 S EH0 Z IY S
escocês|EH0 S K OW0 S EH0 Y S
escolha|IY S K OW0 L IY AA
escolher|IY S K OW0 L IY EH0 RH
escolhos|EH0 S K AO L IY UW S
escolinha|IY S K AO L N IY0 AA
esconder|IY S K D EH0 RH
escorpião|EH0 S K OW0 RH P Y AA W
escorregar|IY S K OW0 RH EH0 G AE RH
escova|IY S K OW0 V AA
escravagismo|IY S K RRR AE V AE ZH IY S M UW
escravismo|IY S K RRR AE V IY S M UW
escravizar|EH0 S K R AE V IY Z AE RH
escrever|IY S K R EH0 V EH0 RH
escrito|EH0 S K R IY T UW
escritor|IY SH K R IY T OW0 RH
escritores|IY SH K R IY T OW0 R IY SH
escritório|IY SH K R IY T AO R Y UW
escrivão|IY S K R IY V AA W
escrotal|IY S K R OW0 T AE W
escumalha|IY SH K UW M AE L IY AE
escumalho|IY SH K UW M AE L IY UW
escuridão|IY S K UW R IY D AA W
escusamos|EH0 S K UW Z AA M UW S
escutar|IY S K UW T AE RH
escápula|EH0 S K AE P UW L AE
esdras|EH Z D R AA S
esforço|IY S F OW0 RH S UW
esfênio|IY S F EH0 N IY UW
esmagamento|IY Z M AE G AA M T UW
esmagar|EH0 Z M AE G AE RH
esmirna|EH0 Z M IY RH N AA
esopo|EH0 Z OW0 P UW
espacial|EH0 S P AE S IY AE W
espadachim|EH0 S P AE D AE SH
espalhar|IY S P AE L IY AE RH
espanhol|EH0 S P AA N IY0 AO W
espantoso|IY S P AA T OW0 Z UW
esparavel|IY S P AE R AE V EH W
esparta|IY S P AE RH T AA
espaço|IY S P AE S UW
especificar|IY S P EH0 S IY F IY K AE RH
específico|IY S P EH0 S IY F IY K UW
espelho|IY SH P EH L IY UW
esperanto|IY S P EH0 R AA T UH
esperança|IY SH P EH0 R AA S AA
esperançadora|EH0 S P EH0 R AA S AE D OW0 R AA
esperar|IY S P EH0 R AE RH
espere|IY SH P EH R IY
esperma|IY S P EH RH M AA
espertinho|EH0 S P EH RH T IY N IY0 UW
esperto|IY SH P EH RH T UW
espesso|IY S P EH S UW
espetar|EH0 S P EH0 T AE RH
espeto|IY S P EH T UW
espetou|IY S P EH0 T OW0 W
espiga|EH0 S P IY G AE
espinela|IY S P IY N EH L AA
espingarda|EH0 S P G AE RH D AA
espinha|EH0 S P IY N IY0 AA
espinho|IY SH P IY N IY0 UW
espirrar|IY S P IY RH AE R
esplêndido|IY S P L D IY D UW
esponsal|IY S P S AE W
espora|EH0 S P AO R AA
espuma|IY SH P M AA
espumaram|EH0 S P UW M AE R AA W
espártaco|EH0 S P AE RH T AE K UW
espécie|IY SH P EH S Y IY
esquecido|IY S K EH0 S IY D UW
esqueleto|EH0 S K EH0 L EH0 T UH
esquema|IY S K EH0 M AA
esqui|IY S K IY
esquimó|EH0 S K IY M AO
esquina|IY S K IY N AA
essa|EH S AA
estabelecer|IY S T AE B EH0 L EH0 S EH0 RH
estabelecida|EH0 S T AE B EH0 L EH0 S IY D AA
estabelecido|EH0 S T AE B EH0 L EH0 S IY D UW
estaca|EH0 S T AE K AA
estado|IY S T AE D UW
estaquia|EH0 S T AE K IY AA
estatura|IY S T AE T UW R AE
estatuto|EH0 S T AE T UW T UW
estavas|EH0 S T AE V AE S
estender|IY S T D EH0 RH
ester|EH0 S T EH RH
esteva|EH0 S T EH0 V AA
esticar|IY S T SH IY K AE RH
estilo|IY S T IY L UW
estimulador|EH0 S T IY M UW L AE D OW0 RH
estimulante|EH0 S T IY M UW L AA T IY
estivador|IY S T IY V AE D OW0
estofado|EH0 S T OW0 F AE D UW
estofo|EH0 S T AO F UW
estol|IY S T AO W
estoma|IY S T OW0 M AE
estopim|IY S T UW P
estourar|IY S T OW0 W R AE RH
estouro|EH0 S T OW0 W R UW
estrada|IY SH T R AE D AA
estrangeirismo|IY S T RRR AA ZH EH0 Y R IY Z M UW
estrangeiro|IY S T R AA ZH EH0 Y R UW
estranho|IY S T R AA N IY0 UW
estranhíssimo|EH0 S T RRR AA N IY0 IY S IY M UW
estratagema|EH0 S T R AE T AE ZH EH0 M AA
estratégia|EH0 S T R AE T EH ZH Y AE
estreiteza|EH0 S T R EH0 Y T EH0 Z AA
estrela|IY S T R EH0 L AA
estremeceu|EH0 S T R EH0 M EH0 S EH0 W
estrompido|EH0 S T R P IY D UW
estrondo|IY S T R D UW
estrume|IY S T R UW M IY
estrutura|IY S T R UW T UW R AA
estrépito|EH0 S T R EH P IY T UW
estudar|IY S T UW D AE RH
estudo|IY SH T UW D UW
estupenda|EH0 S T UW P D AA
estupro|IY S T UW P R UW
esturjão|IY S T UW RH ZH AA W
estádio|IY SH T AE D Y UW
estágio|IY S T AE ZH Y UW
estátua|EH0 S T AE T W AE
estância|IY S T AA S IY AA
estética|IH SH T EH T IY K AA
estêvão|IY S T EH0 V AA W
estímulo|EH0 S T IY M UW L UW
estímulos|EH0 S T IY M UW L UW S
estômago|IY S T OW0 M AE G UW
etapa|EH0 T AE P AA
eternamente|EH0 T EH RH N AE M T IY
eterno|EH0 T EH R N UW
etimologia|EH0 T SH IY M OW0 L OW0 ZH IY AA
etna|EH T N AA
etólogo|EH0 T AO L OW0 G UW
eu|EH0 W
eua|EH0 W AA
eucaliptal|EH0 W K AE L IY P T AE W
eucalipto|EH0 W K AE L IY P T UW
eureca|EH0 W R EH K AA
euro|EH0 W R UW
europa|EH0 W R AO P AA
europeia|EH0 W R OW0 P EH Y AA
europol|EH0 W R OW0 P AO W
eurovisivo|EH0 W R UW V IY Z IY V UW
eurípides|EH0 W R IY P IY D IY S
eustácio|EH0 W S T AE S Y UW
eustáquio|EH0 W S T AE K Y UW
evento|EH0 V T UW
evidenciar|EH0 V IY D S IY AE RH
evocar|EH0 V OW0 K AE
expert|EH K S P EH RH T
exploit|EH0 K S P L AO Y T
fabiano|F AE B Y AA N UW
fabricante|F AE B R IY K AA T IY
faca|F AE K AA
facebook|F EH0 Y Z B UW K IY
faceiro|F AE S EH0 Y R UW
fachada|F AE SH AE D AE
facho|F AE SH UW
facto|F AE K T UW
factício|F AE K T IY S Y UW
factível|F AE T SH IY V EH0 W
faculdade|F AE K UW W D AE D IY
facão|F AE K AA W
fadiga|F AE D IY G AA
fado|F AE D UW
faia|F AE Y AA
faiança|F AE Y AA S AE
faixa|F AE Y SH AA
fake|F EH0 Y K IY
fala|F AE L AA
falam|F AE L AA W
falangeta|F AE L AA ZH EH0 T AE
falanginha|F AE L AA ZH IY N IY0 AE
falena|F AE L EH0 N AA
falha|F AE L IY AA
falo|F AE L UW
familiar|F AA M IY L Y AE RH
faminto|F AA M T UW
famílias|F AA M IY L Y AA S
fancaria|F AA K AE R IY AA
fanfarronice|F F AE RH OW0 N IY S IY
fantasie|F AA T AE Z IY IY
fantasies|F AA T AE Z IY IY S
fapar|F AE P AE R
faq|F AE K
farc|F AE RH K
faro|F AE R UW
farrapo|F AE RH AE P UW
fartura|F AE RH T UW R AE
fashion|F EH SH
fatia|F AE T IY AE
fatiota|F AE T SH IY AO T AA
fato|F AE T UW
fatura|F AE T UW R AA
fatwa|F AE T W AA
fauno|F AE W N UW
fava|F AE V AA
favela|F AE V EH L AA
fazenda|F AE Z D AA
faça|F AE S AA
façam|F AE S AA W
faço|F AE S UW
febre|F EH B R IY
fechadura|F EH0 SH AE D UW R AA
federação|F EH0 D EH0 R AE S AA W
fedor|F EH0 D OW0 RH
feed|F IY D
feedback|F IY D B EH K IY
feioso|F EH0 Y OW0 Z UW
feitio|F EH0 Y T IY W
feitiço|F EH0 Y T IY S UW
felizes|F EH0 L IY Z IH S
femicídio|F EH0 M IY S IY D ZH Y UW
feminicídio|F EH0 M IY N IY S IY D ZH Y UW
feminismo|F EH0 M IY N IY Z M UW
fenestra|F EH N EH S T R AE
fera|F EH R AA
feriado|F EH0 R IY AE D UW
ferida|F IY R IY D AE
ferido|F IY R IY D UW
ferir|F EH0 R IY RH
fernandes|F EH0 R N AA D ZH IY S
ferramenta|F EH RH AA M T AA
ferreirinha|F EH0 RH EH0 Y R IY N IY0 AA
ferrenho|F EH0 RH EH0 N IY0 UW
ferrovia|F EH HH OW0 V IY AE
ferrugem|F EH0 RH UW ZH Y
fertilizante|F EH RH T IY L IY Z AA T IY
ferve|F EH RH V IY
festa|F EH S T AA
festo|F EH S T UW
feto|F EH T UW
feudalismo|F EH0 W D AE L IY SH M UW
feudo|F EH0 W D UW
fi|F IY
fiasco|F IY AE S K UW
ficar|F IY K AE RH
ficará|F IY K AE R AE
fico|F IY K UW
fidúcia|F IY D UW S Y AE
figueira|F IY G EH0 Y R AA
figura|F IY G UW R AA
figurar|F IY G UW R AE RH
figuração|F IY G UW R AE S AA W
fiji|F IY ZH IY
fila|F IY L AA
filado|F IY L AE D UW
filantrópica|F IY L AA T R AO P IY K AA
filantrópico|F IY L AA T R AO P IY K UW
filar|F IY L AE RH
filas|F IY L AA S
fileira|F IY L EH0 Y R AA
filha|F IY L IY AA
filho|F IY L IY UW
filhota|F IY L IY AO T AA
filhó|F IY L IY AO
filipa|F IY L IY P AA
filmar|F IY W M AE RH
filme|F IY W M IY
filo|F IY L UW
filomena|F IY L OW0 M EH0 N AA
filosofal|F IY L OW0 Z OW0 F AE W
filosofia|F IY L OW0 Z OW0 F IY AA
filão|F IY L AA W
filé|F IY L EH
filósofo|F IY L AO Z OW0 F UW
fim|F
finai|F IY N AE Y
finale|F IY N AE L IY
finalizar|F IY N AE L IY Z AE RH
finalização|F IY N AE L IY Z AE S AA W
finalzinho|F IY N AE W Z IY N IY0 UW
financeiro|F IY N AA S EH0 Y R UW
financiar|F IY N AA S IY AE RH
finando|F IY N AA D UW
finanças|F IY N AA S AA S
finara|F IY N AE R AA
finaram|F IY N AE R AA W
finava|F IY N AE V AA
finavam|F IY N AE V AA W
findo|F D UW
finesa|F IY N EH0 Z AA
fineza|F IY N EH0 Z AA
fingimento|F ZH IY M T UW
fingir|F ZH IY RH
finita|F IY N IY T AA
finito|F IY N IY T UW
finlandesa|F L AA D EH0 Z AA
finou|F IY N OW0 W
finta|F T AA
fio|F IY UW
fique|F IY K IY
firula|F IY R UW L AE
fisgada|F IY Z G AE D AA
fita|F IY T AA
fitness|F IY T N EH0 S
fivela|F IY V EH L AA
fixar|F IY K S AE RH
fixo|F IY K S UW
fizera|F IY Z EH R AA
fizeram|F IY Z EH R AA W
flaca|F L AE K AA
flaco|F L AE K UW
flagelo|F L AE ZH EH0 L UW
flagrante|F L AE G R AA T IY
flagrantes|F L AE G R AA T IY S
flamengo|F L AA M G UW
flamingo|F L AA M G UW
flamífero|F L AE M IY F EH0 R UW
flamígero|F L AE M IY ZH EH0 R UW
flanco|F L AA K UW
flanela|F L AE N EH L AE
flango|F L AA G UW
flashback|F L EH SH IY B EH K IY
flatulência|F L AE T UW L S Y AE
flauta|F L AE W T AA
fleuma|F L EH0 W M AE
flood|F L AA D
flora|F L AO R AA
florença|F L OW0 R S AA
floresta|F L OW0 R EH S T AA
florete|F L OW0 R EH0 T IH
florzinha|F L OW0 RH Z IY N IY0 AA
flume|F L UW M IY
fluxo|F L UW K S UW
fluência|F L UW S Y AE
fluído|F L UW IY D UW
fobia|F OW0 B IY AE
foca|F AO K AA
focar|F OW0 K AE RH
foco|F AO K UW
foda|F AO D AE
fodo|F OW0 D UW
fodão|F AO D AA W
fodões|F AO D Y SH
fofo|F OW0 F UW
fofoca|F AO F AO K AE
fofura|F OW0 F UW R AE
fogaréu|F OW0 G AE R EH W
fogaça|F OW0 G AE S AE
fogem|F AO ZH Y
fogueira|F OW0 G EH0 Y R AA
foguete|F UW G EH0 T SH IY
foi|F OW0 Y
folclórico|F OW0 W K L AO R IY K UW
folha|F AO L IY AA
folhear|F OW0 L IY EH0 AE R
folho|F OW0 L IY UW
folhos|F AO L IY UW S
folia|F OW0 L IY AA
folk|F OW0 W K IY
fona|F OW0 N AA
fondue|F D IY
fonema|F OW0 N EH0 M AA
fora|F AO R AA
foram|F OW0 R AA W
forasteiro|F OW0 R AE S T EH0 Y R UW
forja|F AO RH ZH AA
formar|F OW0 RH M AE RH
formato|F OW0 RH M AE T UW
formiga|F OW0 R M IY G AE
formoso|F OW0 RH M OW0 Z UW
formulário|F OW0 RH M UW L AE R Y UW
fornecer|F OW0 RH N EH0 S EH0 RH
fornecimento|F OW0 RH N EH0 S IY M T UW
foro|F AO R UW
forragem|F OW0 RH AE ZH Y
forró|F AO RH AO
fortalecer|F OW0 RH T AE L EH0 S EH0 RH
forte|F AO RH T IY
fortificação|F OW0 RH T IY F IY K AE S AA W
força|F OW0 RH S AA
forçado|F OW0 R S AE D UW
forçar|F OW0 RH S AE RH
foto|F AO T UW
fraca|F R AE K AA
fraco|F R AE K UW
frame|F R EH0 Y M IY
francesa|F R AA S EH0 Z AA
francisco|F R AA S IY S K UW
franco|F R AA K UW
francês|F R AA S EH0 Y S
franga|F R AA G AA
frangalho|F R AA G AE L IY UW
frango|F R AA G UW
frank|F R AA K IY
frankfurt|F R AA K F UW RH T
frança|F R AA S AA
frapê|F R AE P EH0
fraqueza|F R AE K EH0 Z AE
frasco|F R AE S K UW
frase|F R AE Z IY
fraternidade|F R AE T EH0 RH N IY D AE D IY
fração|F R AE S AA W
frederico|F R EH0 D EH0 R IY K UW
freegan|F R IY G AA
fremente|F R EH0 M T SH IY
frenético|F R EH0 N EH T IY K UW
freqüentemente|F R EH0 K W T IY M T IY
fresco|F R EH0 S K UW
frescura|F R EH0 S K UW R AE
fresquear|F R EH0 S K Y AE RH
frete|F R EH T SH IY
fria|F R IY AA
friagem|F R IY AE ZH Y
frialdade|F R IY AE W D AE D ZH IY
fricção|F R IY K S AA W
frigir|F R IY ZH IY RH
frincha|F R SH AA
friorento|F R IY OW0 R T UW
friulano|F R IY W L AA N UW
froco|F R AO K UW
fronte|F R T IY
fronteira|F R T EH0 Y R AA
frouxidão|F R OW0 W SH IY D AA W
frouxo|F R OW0 W SH UW
frufru|F R UW F R UW
fruição|F R UW Y S AA W
fruta|F R UW T AA
fruteira|F R UW T EH0 R AA
fruto|F R UW T UH
frágil|F R AE ZH IY W
frângão|F R AA G AA W
frísio|F R IY Z Y UW
frívolo|F R IY V OW0 L UW
fueguino|F UW EH0 G IY N UW
fuga|F UW G AA
fugir|F UW ZH IY RH
fui|F UW Y
fujão|F UW ZH AA W
fulano|F UW L AA N UW
fulcral|F UW W K R AE W
fulgurar|F UW W G UW R AE RH
fuligem|F UW L IY ZH Y
fulá|F UW L AE
fumacê|F UW M AE S EH0
fumar|F UW M AE RH
fumaça|F UW M AE S AA
fume|F UW M IY
fumeante|F UW M EH0 T SH IY
fumegante|F UW M EH0 G T SH IY
fumo|F UW M UW
fumoso|F UW M OW0 Z UW
fumígeno|F UW M IY ZH EH0 N UW
funcho|F SH UW
funcionamento|F S Y OW0 N AE M T UW
funda|F D AE
fundamentais|F D AE M T AE Y S
fundamental|F D AE M T AE W
fundamento|F D AA M T UW
fundação|F D AE S AA W
fundir|F D IY RH
fundo|F D UW
fundão|F D AA W
fungando|F G AA D UW
fungar|F G AE RH
fungicida|F ZH IY S IY D AE
fungo|F G UW
fungou|F G OW0 W
funkeiro|F AA K EH0 Y R UW
funks|F AA K IY S
função|F S AA W
furadeira|F UW R AE D EH0 Y R AE
furem|F UW RRR Y
furibundo|F UW R IY B D UW
furioso|F UW R Y OW0 Z UW
furo|F UW R UW
furou|F UW R OW0 W
furão|F UW R AA W
fusa|F UW Z AA
fustigar|F UW S T IY G AE RH
futebol|F UW T IY B AO W
futicar|F UW T SH IY K AE RH
futrica|F UW T R IY K AE
futricada|F UW T R IY K AE D AE
futricagem|F UW T R IY K AE ZH AA Y
futricar|F UW T R IY K AE RH
futriqueiro|F UW T R IY K EH0 Y R UW
futucar|F UW T UW K AE RH
futum|F UW T
futuro|F UW T UW R UW
fuxicar|F UW SH IY K AE HR
fuxico|F UW SH IY K UW
fuxiqueiro|F UW SH IY K EH0 Y R UW
fuê|F W EH0
fá|F AE
fábrica|F AE B R IY K AA
fábula|F AE B UW L AE
fácil|F AE S IY W
fã|F AA
fé|F EH
fécula|F EH K UW L AA
fíbula|F IY B UW L AE
fíji|F IY ZH IY
física|F IY Z IY K AA
físico|F IY Z IY K UW
fócida|F AO S IY D AA
fólio|F AO L Y UW
fórum|F AO R
g|ZH EH0
gabi|G AE B IY
gabão|G AE B AA W
gagaúzia|G AE G AE UW Z IY AA
gaia|G AE Y AA
gaiatar|G AE Y AE T AE HR
gaiatice|G AE Y AE T SH IY S IY
gaiato|G AE Y AE T UW
gaio|G AE Y UW
gaita|G AE Y T AA
gaitar|G AE Y T AE HR
gaitaço|G AE Y T AE S UW
gaiteiro|G AE Y T EH0 Y R UW
gaivota|G AE Y V AO T AE
gajo|G AE ZH UW
gala|G AE L AA
galeria|G AE L EH0 R IY AA
galhada|G AE L IY AE D AA
galho|G AE L IY UW
galileu|G AE L IY L EH0 W
galinha|G AE L IY N IY0 AA
galo|G AE L UW
galopeado|G AE L OW0 P IY AE D UW
galáxia|G AE L AE K S Y AE
galé|G AE L EH
galípoli|G AE L IY P OW0 L IY
gamba|G AA B AA
gambá|G AA B AE
game|G EH0 Y M IY
gancho|G AA SH UW
gandhi|G AA D IY
ganga|G AA G AA
gansa|G AA S AA
ganso|G AA S UW
ganza|G AA Z AA
garagem|G AE R AE ZH Y
garantir|G AE R AA T IY RH
gardênia|G AE RH D N Y AA
garfo|G AE RH F UW
gari|G AE R IY
garnisé|G AE RH N IY Z EH
garota|G AE R OW0 T AA
garoto|G AE R OW0 T UW
garrafas|G AE RH AE F AA SH
garrafeira|G AE RH AE F EH0 Y R AA
garrafão|G AE RH AE F AA W
garrancho|G AE HH AA SH UW
garrido|G AA RH IY D UW
garrir|G AA RH IY R
garça|G AE RH S AA
gastar|G AE S T AE RH
gastronomia|G AE S T R OW0 N OW0 M IY AE
gata|G AE T AA
gate|G EH0 Y T
gatilho|G AE T IY L IY UW
gatinho|G AE T IY N IY0 OW0
gato|G AE T UW
gaveta|G AE V EH0 T AE
gaza|G AE Z AA
gaúcho|G AE UW SH UW
gelatina|ZH EH0 L AE T IY N AE
gelinski|ZH EH0 L S K IY
gelo|ZH EH L UW
gengiva|ZH ZH IY V AA
genioso|ZH EH0 N IY OW0 Z UW
genitiva|ZH EH0 N IY T IY V AE
genoveva|ZH EH0 N OW0 V EH V AA
gentalha|ZH T AE L IY AA
gentílico|ZH T SH IY L IY K UW
geocêntrico|ZH EH0 OW0 S T R IY K UW
geovane|ZH EH0 W V AA N IY
gerais|ZH EH0 R AE Y S
gerar|ZH EH0 R AE RH
gerardo|ZH EH0 R AE RH D UW
geração|ZH EH0 R AE S AA W
gerenciamento|ZH EH0 R S Y AE M T UW
gerenciar|ZH EH0 R S IY AE RH
gerente|ZH EH0 R T IY
geringonça|ZH EH0 R G S AA
gerontocracia|ZH EH0 R OW0 N T OW0 K R AE S IY AA
gerânio|ZH IY R AA N IY UW
gerência|ZH EH0 R S Y AA
gesso|ZH EH0 S UW
gestor|ZH EH0 S T OW0 RH
gestão|ZH EH0 S T AA W
gibi|ZH IY B IY
gibraltar|ZH IY B R AE W T AE RH
giga|ZH IY G AE
gigabit|ZH IY G AE B IY T IY
gigabyte|ZH IY G AE B AE Y T SH IY
gigolô|ZH IY G OW0 L OW0
gigote|ZH IY G AO T SH IY
gilberto|ZH IY W B EH RH T UW
gilete|ZH IY L EH T SH IY
gim|ZH
gineta|ZH IY N EH0 T AA
ginete|ZH IY N EH0 T IY
ginga|ZH G AA
ginásio|ZH IY N AE Z Y UW
gioconda|ZH IY OW0 K D AA
giovana|ZH IY OW0 V AA N AE
gipsita|ZH IY P S IY T AA
girafa|ZH IY R AE F AA
girassol|ZH IY R AE S AO W
giratório|ZH IY R AE T AO R Y UW
giro|ZH IY R UW
girândola|ZH IY R AA D OW0 L AA
gisela|ZH IY Z EH L AA
giz|ZH IY S
gizé|ZH IY Z EH
glande|G L AA D IY
glasnost|G L AE S N AO S T
glauca|G L AE W K AA
glauco|G L AE W K UW
gleba|G L EH B AE
glicina|G L IY S IY N AA
glifo|G L IY F UW
glitter|G L IY T EH0 RH
glorificação|G L OW0 R IY F IY K AE S AA W
glosar|G L UW Z AE R
gládio|G L AE D ZH Y UW
glândula|G L AA D UW L AA
glúten|G L UW T Y
gnomo|G N OW0 M UW
gnose|G N AO Z IY
gnosticismo|G N OW0 S T IY S IY Z M UW
gnu|G N UW
goa|G OW0 AA
godo|G OW0 D UW
godofredo|G OW0 D OW0 F R EH0 D UW
goi|G AO Y
goiabada|G OW0 Y AE B AE D AA
goiabeira|G OW0 Y AE B EH0 Y R AE
goivo|G OW0 Y V UW
gola|G AO L AA
goleador|G OW0 L EH0 AE D OW0 RH
golfinho|G OW0 W F IY N IY0 UW
golo|G OW0 L UW
golpe|G AO W P IY
golpear|G OW0 W P IY AE RH
gols|G OW0 W S
gonzo|G Z UW
google|G UW G OW0 L
gordice|G OW0 RH D IY S IY
gordo|G OW0 R D UW
gorila|G OW0 R IY L AA
gorovinha|G OW0 R AO V IY N IY0 AE
gota|G AO T AA
goteira|G OW0 T EH0 Y R AE
gourmand|G UW RH M AA
governar|G OW0 V EH0 RH N AE RH
governo|G UW V EH0 RH N UW
gozo|G AO Z UW
grade|G R AE D ZH IY
grado|G R AE D UW
graduação|G R AE D UW AE S AA W
grafo|G R AE F UW
grafíti|G R AE F IY T IY
gralha|G R AE L IY AA
gramatical|G RRR AE M AE T SH IY K AE W
grampear|G R AA P Y AE RH
grampo|G R AA P UW
grana|G RRR AA N AA
granada|G R AE N AE D AA
grandão|G R AA D AA W
granja|G R AA ZH AA
granulatura|G R AA N UW L AE T UW R AA
gratuito|G R AE T UW Y T UW
grau|G R AE W
grava|G R AE V AA
gravata|G R AE V AE T AA
gravidade|G R AE V IY D AE D IY
graviola|G R AE V IY AO L AE
graxa|G R AE SH AA
graça|G R AE S AA
grecidade|G R EH0 S IY D AE D IY
grego|G R EH0 G UW
grei|G RRR EH Y
grelo|G R EH0 L UW
grenha|G R EH0 N IY0 AA
greva|G R EH V AE
grife|G R IY F IY
grifo|G R IY F UW
grilo|G R IY L UW
gripar|G R IY P AE RH
gripes|G R IY P IY S
grisalho|G R IY Z AE L IY UW
griso|G R IY Z UW
grisu|G R IY Z UW
grisão|G R IY Z AA W
grisões|G R IY Z Y S
gritinhos|G R IY T IY N IY0 UW S
grito|G R IY T UW
gritão|G R IY T AA W
groselha|G R OW0 Z EH L IY AE
grosseria|G R OW0 S EH0 R IY AE
grosso|G R OW0 S UW
grossura|G R OW0 S UW R AA
grostoli|G R AO S T OW0 L IY
grotesca|G R OW0 T EH0 S K AA
grou|G R OW0 W
grua|G R UW AA
grude|G R UW D IY
grupo|G R UW P UW
gruta|G R UW T AE
gráfica|G R AE F IY K AA
gráfico|G R AE F IY K UW
grã|G R AA
grão|G R AA W
guabiju|G W AE B IY ZH UW
guapo|G W AE P UW
guardar|G W AE RH D AE RH
guarida|G W AE R IY D AE
guarita|G W AE R IY T AE
guarujá|G W AE R UW ZH AE
guarulhense|G W AE R UW L IY S IY
guarulhos|G W AE R UW L IY UW S
gude|G UW D ZH IY
gugla|G UW G L AA
guia|G IY AA
guido|G IY D UW
guilhermina|G IY L IY EH0 RH M IY N AA
guindar|G IY N D AE RRR
guiné|G IY N EH
guinéu|G IY N EH W
guisa|G IY Z AA
guita|G IY T AA
guitarra|G IY T AE RH AA
guizo|G IY Z UW
gulodice|G UW L OW0 D ZH IY S IY
gulosice|G UW L OW0 Z IY S IY
gume|G UW M IY
gunda|G D AA
guri|G UW R IY
guru|G UW R UW
guê|G EH0
gástrico|G AE SH T R IY K UW
géis|ZH EH0 Y SH
gê|ZH EH0
gói|G AO Y
gôndola|G D OW0 L AA
h|HH
habilidade|AE B IY L IY D AE D IY
habilitar|AE B IY L IY T AE RH
habitante|AE B IY T AA T IY
habitação|AE B IY T AE S AA
hacker|HH AE K EH0 R
haddad|AE D AE D
haia|AE Y AA
haja|AE ZH AA
hall|HH AO W
halterofilista|AE W T EH0 R OW0 F IY L IY S T AA
hamburger|AA B UW RRR G EH0 RRR
hamlet|HH EH M L EH0 T
hangul|AA G UW W
hanna|RH AA N AA
harpa|AE RH P AA
harvard|HH AE RH V AE RH D
hasta|AE S T AA
haste|AE S T SH IY
hata|AE T AA
hater|RH EH0 Y T EH0 R
havai|AE V AE Y
havaí|AE V AE IY
havendo|AE V D UW
hebraização|EH0 B R AE Y Z AE S AA W
hebrom|EH0 B R
hediondo|EH0 D IY D UW
hein|Y
helena|EH0 L EH0 N AA
heleno|EH0 L EH0 N UW
helicóptero|EH0 L IY K AO P IY T EH0 R UW
heliocêntrico|EH L Y OW0 S T R IY K UW
heloísa|EH0 L W IY Z AA
henrique|RH IY K IY
henriqueta|RH IY K EH0 T AA
hera|EH R AA
hermano|EH0 RH M AA N UW
heráldica|EH0 R AE W D IY K AE
hesitante|EH0 Z IY T AA T IY
heterossexual|EH T EH0 R UW K S UW AE W
hexa|EH K S AE
hexágono|EH0 G Z AE G OW0 N UW
hibakusha|HH IY B AE K UW SH AE
hidrargírio|IY D R AE RH ZH IY R IY UW
hidrelétrico|IY D R EH0 L EH T R IY K UW
hidroelétrico|IY D R OW0 EH0 L EH T R IY K UW
hidrografia|IY D R OW0 G R AE F IY AE
highlander|HH AE Y L AA D EH0 RH
higia|IY ZH IY AA
higienização|IY ZH IY EH0 N IY Z AE S AA W
hilda|IY W D AA
hildebrando|IY W D EH0 B R AA D UW
hilário|IY L AE RRR Y UW
hindi|D IY
hindu|D UW
hino|IY N UW
hipocondria|IY P OW0 K D R IY AE
hipocrisia|IY P OW0 K R IY Z IY AE
hipotensão|HH IY P OW0 T S AA W
hisako|IY Z AE K UW
histeria|IY S T EH0 R IY AA
historicamente|IY S T AO R IY K AA M T IY
história|IY S T AO R Y AA
histórico|IY SH T AO R IY K UW
hitler|HH IY T L EH0 RH
hobby|HH AO B IY
hodiernamente|OW0 D ZH IY EH0 R N AE M T SH IY
holandês|OW0 L AA D EH0 Y S
hollywood|HH AO L IY W UW D IY
holocausto|OW0 L OW0 K AE W S T UW
holofote|OW0 L OW0 F AO T IY
homenagem|AO M N AE ZH Y
homens|OW0 M Y S
homenzinho|OW0 M Y Z N IY0 UW
homero|OW0 M EH R UW
homicídio|OW0 M IY S IY D ZH Y UW
homologação|OW0 M OW0 L OW0 G AE S AA W
homossexual|OW0 M OW0 S EH0 K S UW AE W
homão|OW0 M AA W
honestidade|OW0 N EH0 S T IY D AE D IY
honesto|OW0 N EH S T UW
honrosa|RH AO Z AA
honroso|RH OW0 Z UW
hoplita|OW0 P L IY T AA
hora|AO R AA
horinha|AO R IY N IY0 AA
horrível|OW0 RH IY V EH0 W
horta|AO RH T AA
hortelã|AO HH T EH L AA
hortifrúti|OW0 RH T IY F R UW T IY
hospedagem|OW0 S P EH0 D AE ZH Y
hospedar|OW0 S P EH0 D AE RH
hospital|AO S P IY T AE W
host|HH OW0 W S T
hostil|OW0 S T IY W
hotel|OW0 T EH W
huawei|W AE W EH0 Y
hue|HH UW EH0
hulha|UW L IY AA
humanidade|UW M AA N IY D AE D IY
humanismo|UW M AA N IY Z M UW
humanitário|UW M AA N IY T AE R Y UW
humano|UW M AA N UW
humilhação|UW M IY L IY AE S AA W
humo|UW M UW
hungria|G R IY AA
hussardo|UW S AE RH D UW
há|AE
hábito|AE B IY T UW
hão|AA W
hélade|EH L AE D IY
hélio|EH L Y UW
hérnia|EH RH N IY AA
hétero|EH T EH0 R UW
hóplon|AO P L
hóspedes|AO S P EH0 D IY S
húmus|UW M UW SH
hũa|AA
ia|IY AA
ialta|Y AE W T AA
iam|IY AA W
ian|Y AA
ibérico|IY B EH R IY K UW
iceberg|AE Y S IY B EH RH G IY
icônico|IY K OW0 N IY K UW
ida|IY D AA
idealização|IY D EH0 AE L IY Z AE S AA W
idem|IY D Y
identidade|IY D T IY D AE D IY
identificar|IY D T IY F IY K AE RH
ideologia|IY D IY OW0 L OW0 ZH IY AA
idioma|IY D IY OW0 M AA
idiota|IY D Y AO T AA
ido|IY D UW
idoso|IY D OW0 Z UW
idílio|IY D IY L Y UW
idóneo|IY D OW0 N Y UW
idôneo|IY D OW0 N Y UW
ignaro|IY G N AE R UW
ignorante|IY G N OW0 R AA T IY
ignorar|IY G N OW0 R AE RH
ignóbeis|IY G N AO B EH0 Y S
ignóbil|IY G IY N AO B IY W
igor|IY G OW0 RH
igreja|IY G R EH0 ZH AA
igualha|IY G W AE L IY AA
igualzinho|IY G W AE W Z N IY0 UW
ilegível|IY L EH0 ZH IY V EH0 W
ilha|IY L IY AA
ilhéu|IY L IY EH W
ilibado|IY L IY B AE D UW
illinois|IY L IY N AO Y
iluminismo|IY L UW M IY N IY Z M UW
ilusionista|IY L UW Z Y OW0 N IY SH T AA
ilustrar|IY L UW S T R AE RH
imagem|IY M AE ZH Y
imaginar|IY M AE ZH IY N AE RH
imanente|IY M AE N T SH IY
imanência|IY M AE N S Y AE
imbatível|B AE T IY V EH0 W
imediato|IY M EH0 D ZH IY AE T UW
imenso|IY M Y S UW
imigração|IY M IY G R AE S AA W
imitam|IY M IY T AA W
impaciente|P AE S Y T IY
impacientes|P AE S Y T IY S
impacto|P AE K T UW
impala|P AE L AA
impasse|P AE S IY
impera|P EH R AA
imperativa|P EH0 R AE T IY V AA
imperdível|P EH0 RH D IY V EH0 W
imperecibilidade|P EH0 RRR EH0 S IY B IY L IY D AE D ZH IY
imperialmente|P EH R IY AE W M T IY
imperiosa|P EH0 R Y AO Z AA
impertinente|P EH0 RH T IY N T IY
impertinência|P EH0 RH T IY N S Y AA
impessoalidade|P EH0 S UW AE L IY D AE D ZH IY
impeça|P EH S AA
impingir|P ZH IY R
implausível|P L AE W Z IY V EH0 W
implementar|P L EH0 M T AE RH
impoluto|P OW0 L UW T UW
impopular|P OW0 P UW L AE RH
impopularidade|P OW0 P UW L AE R IY D AE D IY
impor|P OW0 RH
importância|P OW0 RH T AA S Y AA
impossível|P OW0 S IY V EH0 W
imposto|P OW0 S T UW
impraticabilidade|P RRR AE T SH IY K AE B IY L IY D AE D ZH IY
impraticável|P RRR AE T SH IY K AE V EH0 W
imprensa|P R S AA
imprescritível|P R EH0 S K RRR IY T SH IY V EH0 W
impressa|P R EH S AA
imprimir|P R IY M IY RH
improvável|P R OW0 V AE V EH0 W
impulsivamente|P UW W S IY V AA M T IY
impuro|P UW R UW
imundície|IY M D IY S Y IY
imã|IY M AA
imóvel|IY M AO V EH0 W
inacabado|IY N AE K AE B AE D UW
inacabável|IY N AE K AE B AE V EH0 W
inarticulada|IY N AE RH T IY K UW L AE D AA
incapacidade|K AE P AE S IY D AE D IY
incapacitar|K AE P AE S IY T AE RH
incapaz|K AE P AE Y S
incauto|K AE W T UW
incel|S EH W
incensar|S S AE RH
incenso|S S UW
incentivar|S T IY V AE RH
incerteza|S EH0 RH T EH0 Z AA
incesto|S EH S T UW
inchaço|SH AE S UW
incisiva|S IY Z IY V AA
incisivo|S IY Z IY V UW
incitador|S IY T AE D OW0 RH
incluindo|K L UW D UW
incluir|K L UW IY RH
incluso|K L UW Z UW
incolumidade|K OW0 L UW M IY D AE D ZH IY
incomodar|K OW0 M OW0 D AE RH
incomparável|K P AE R AE V EH0 W
inconsciente|K S IY T IY
inconsciência|K S IY S IY AA
inconsolada|K S OW0 L AE D AA
inconstante|K S T AA T IY
incorporar|K OW0 RH P OW0 R AE RH
incrementar|K RRR EH0 M T AE R
incrédulo|K RRR EH D UW L UW
incrível|K R IY V EH W
incumprimento|K P R IY M T UW
incutir|K UW T SH IY R
incêndio|S D Y UW
indecente|D EH0 S T IY
independente|D EH0 P D T EH0
independência|D EH0 P D S Y AA
indicar|D IY K AE RH
indissociável|D ZH IY S OW0 S IY AE V EH0 W
individual|D IY V IY D UW AE W
indivíduo|D ZH IY V IY D W UW
indo|D UW
indulto|D UW W T UW
indústria|D UW S T R Y AA
inepta|IY N EH P T AA
inepto|IY N EH P T UW
inerência|IY N EH0 R S Y AE
inesperada|IY N EH0 S P EH0 R AE D AA
inexoravelmente|IY N EH0 Z OW0 R AE V EH0 W M T IY
inexorável|IY N EH0 Z OW0 R AE V EH0 W
infantilmente|F AA T IY W M T IY
inferno|F EH RH N UW
infiltração|F IY W T R AE S AA W
infindo|F D UW
infinita|F IY N IY T AA
infinitivo|F N IY T IY V UW
influenciar|F L UW S IY AE RH
influência|F L UW S Y AA
informar|F OW0 RH M AE RH
informação|F OW0 RH M AE S AA W
informática|F OW0 RH M AE T IY K AA
ingerência|ZH EH0 R S Y AE
ingrid|G R IY D IY
inguchétia|G UW SH EH T Y AA
ingurgitamento|G UW RH ZH IY T AE M T UW
inhapa|IY N IY0 AE P AA
iniciante|IY N IY S IY AA T SH IY
iniciar|IY N IY S IY AE RH
inimizade|IY N IY M IY Z AE D IY
iniquidade|IY N IY K W IY D AE D ZH IY
injete|ZH EH T SH IY
injeção|ZH EH S AA W
injúria|ZH UW R Y AA
inquisição|K IY Z IY S AA W
insalubre|S AE L UW B R IY
insano|S AA N UW
inseguro|S EH0 G UW R UW
insensato|S S AE T UW
insensatos|S S AE T UW S
insensibilidade|S S IY B IY L IY D AE D IY
inseto|S EH T UW
insidiosa|S IY D Y AO Z AA
insinuar|S IY N UW AE RH
insistir|S IY S T SH IY RH
insofismável|S OW0 F IY S M AE V EH0 W
insolvente|S AO W V T IY
insondável|S D AE V EH0 W
inspirar|S P IY R AE RRR
instalar|S T AE L AE RH
instaurar|S T AE W R AE RH
instigador|S T IY G AE D OW0 RH
instinto|S T T UW
instintos|S T T UW S
instituição|S T SH IY T UW Y S AA W
instituto|S T SH IY T UW T UW
instrumento|S T R UW M T UW
instrutiva|S T R UW T IY V AA
instável|S T AE V EH0 W
instância|S T AA S Y AA
insubordinação|S UW B OW0 R D ZH IY N AE S AA W
insuficiente|S UW F IY S IY T IY
insulina|S UW L IY N AA
insumo|S UW M UW
insurreição|S UW RH EH0 Y S AA W
insuscetível|S UW S EH0 T SH IY V EH0 W
insígnia|S IY G IY N Y AA
insônia|S OW0 N Y AE
int|T
intacto|T AE K T UW
intactos|T AE K T UW S
integerrimamente|T EH0 ZH EH RH IY M AA M T IY
integérrimo|T EH0 ZH EH RH IY M UW
inteiro|T EH Y R UW
intelectual|T EH0 L EH K T UW AE W
inteligência|T EH0 L IY ZH S Y AE
intensa|T S AA
intensamente|T S AA M T IY
intento|T T UW
intenção|T S AA W
intercessor|T EH0 RH S EH0 S OW0 RH
intercorrência|T EH0 R K OW0 RH S Y AE
interesse|T EH0 R EH0 S IY
interesseiro|T EH0 R EH0 S EH0 Y R UW
interferência|T EH0 RH F EH0 R S IY AA
interior|T EH0 R Y OW0 RH
interiorano|T EH0 R Y OW0 R AA N UW
internauta|T EH0 RH N AE W T AA
internação|T EH0 HR N AE S AA W
internet|T EH0 HR N EH T SH IY
interno|T EH RH N UW
interpretar|T EH0 RH P R EH0 T AE RH
interpretação|T EH0 RH P R EH0 T AE S AA W
interrogativa|T EH0 RH OW0 G AE T IY V AA
intifada|T IY F AE D AA
intimamente|T IY M AE M T IY
intimidade|T M IY D AE D ZH IY
intracraniana|T R AE K R AA N Y AA N AA
intracraniano|T R AE K R AA N Y AA N UW
intragável|T RRR AE G AE V EH0 W
intransigência|T RRR AA Z IY ZH S Y AA
intrigue|T R IY G IY
introduzir|T R OW0 D UW Z IY RH
introdução|T R OW0 D UW S AA W
intromete|T R OW0 M EH T SH IY
intuitivo|T UW IY T IY V UW
invasão|V AE Z AA W
invencível|V S IY V EH0 W
inventando|V T AA D UW
inventário|V T AE R Y UW
investigador|V EH0 S T IY G AE D OW0 RH
investigar|V EH0 S T IY G AE RH
investigação|V EH0 S T SH IY G AE S AA W
investimento|V EH0 S T IY M T UW
investir|V EH0 S T SH IY RH
inviabilidade|V IY AE B IY L IY D AE D ZH IY
invocar|V OW0 K AE RH
invólucro|V AO L UW K R UW
inácio|IY N AE S Y UW
início|IY N IY S Y UW
iníquo|IY N IY K W UW
inútil|IY N UW T SH IY W
ionosfera|Y OW0 N OW0 S F EH R AE
ipê|IY P EH0
ira|IY R AA
irene|IY R EH0 N IY
iria|IY R IY AA
ironicamente|IY R OW0 N IY K AA M T IY
irracionalidade|IY RH AE S IY UW N AE L IY D AE D IY
irregularidades|IY RH EH0 G UW L AE R IY D AE D IY S
irrelevante|IY RH EH0 L EH0 V AA T IY
irrepreensível|IY RH EH0 P R EH0 S IY V EH0 W
irritante|IY RH IY T AA T IY
irrupção|IY RH UW P S AA W
irá|IY R AE
irã|IY R AA
irão|IY R AA W
irônico|IY R N IY K UW
is|IY S
isaura|IY Z AE W R AA
isca|IY S K AA
isenta|IY Z T AA
isentar|IY Z T AE R
isento|IY Z T UW
isenção|IY Z S AA W
isis|IY Z IY S
islamização|IY Z L AA M IY Z AE S AA W
islandês|IY Z L AA D EH0 Y S
ismael|IY Z M AE EH W
isolação|IY Z OW0 L AE S AA W
isopor|IY Z OW0 P OW0 RH
isqueiro|IY S K EH0 Y R UW
isso|IY S UW
italiano|IY T AE L Y AA N UW
itamaraty|IY T AE M AE R AE T SH IY
item|IY T Y
itera|IY T EH RRR AE
iterar|IY T EH0 R AE HR
ivan|IY V AA
ião|IY AA W
içado|IY S AE D UW
iço|IY S UW
iídiche|IY D IY SH IY
j|ZH AO T AA
jaca|ZH AE K AA
jacarezinho|ZH AE K AE R EH Z Y UW
jacarta|ZH AE K AE RH T AA
jacto|ZH AE T UW
jaez|ZH AA EH0 SH
jaime|ZH AE Y M IY
jair|ZH AE IY RH
jaleco|ZH AE L EH K UW
jamanta|ZH AE M AA T AA
jambo|ZH AA M B UW
jamelão|ZH AE M EH0 L AA W
jandira|ZH AA D IY R AE
janela|ZH AA N EH L AA
janelas|ZH AA N EH L AA S
janelinha|ZH AA N EH L N IY0 AA
janelona|ZH AA N EH L N AA
janelão|ZH AA N EH L AA W
jangada|ZH AA G AE D AA
janotar|ZH AE N OW0 T AE HR
janta|ZH AA T AA
jantava|ZH AA T AE V AA
janízaro|ZH AA N IY Z AE R UW
japa|ZH AE P AA
japonesa|ZH AE P OW0 N EH0 Z AA
japonês|ZH AE P OW0 N EH0 Y SH
jaqueta|ZH AE K EH0 T AA
jardim|ZH AE RH D Y
jargão|ZH AE RH G AA W
jasmim|ZH AE Z M
jato|ZH AE T UW
jau|ZH AE W
jaula|ZH AE W L AA
java|ZH AE V AA
javalina|ZH AE V AE L IY N AE
javé|ZH AE V EH
jazz|D EH S
jean|ZH EH0 AA
jeans|D S
jenifer|D ZH N IY F EH0 RH
jeová|ZH EH0 OW0 V AE
jericó|ZH EH0 R IY K AO
jessé|ZH EH0 S EH
jetro|ZH EH T R UW
jihad|ZH IY RH AE D
jiló|ZH IY L AO
joana|ZH UW AA N AA
job|D ZH AO B IY
jogging|D AO G
joguetar|ZH OW0 G EH0 T AE HR
joguete|ZH OW0 G EH T SH IY
joia|ZH AO Y AA
joice|ZH AO Y S IY
joinha|ZH AO IY N IY0 AA
joio|ZH OW0 Y UW
jonas|ZH OW0 N AA S
jonathan|ZH OW0 N AE T AA
jorna|ZH AO RH N AA
jornada|ZH OW0 RH N AE D AA
josué|ZH OW0 Z UW EH
josé|ZH UW Z EH
jota|ZH AO T AA
joãozinho|ZH W AA W Z IY N IY0 UW
ju|ZH UW
juba|ZH UW B AA
judaico|ZH UW D AE Y K UW
judas|ZH UW D AA S
judicial|ZH UW D IY S Y AE W
juizado|ZH UW IY Z AE D UW
juju|ZH UW ZH UW
julgadora|ZH UW W G AE D OW0 R AE
julho|ZH UW L IY UW
juliana|ZH UW L Y AA N AA
juliano|ZH UW L Y AA N UW
juliet|ZH UW L IY EH T SH IY
jumento|ZH UW M T UW
junco|ZH K UW
junta|ZH T AA
juntar|ZH T AE RH
juntas|ZH T AA S
junto|ZH T UW
juntos|ZH T UW S
jura|ZH UW R AE
jurandir|ZH UW R AA D IY RH
juro|ZH UW R UW
juscelino|ZH UW S EH0 L IY N UW
juso|ZH UW Z UW
justificar|ZH UW S T SH IY F IY K AE RH
justificativa|ZH UW S T IY F IY K AE T IY V AE
justina|ZH UW S T IY N AA
justino|ZH UW S T IY N UW
juvenis|ZH UW V EH0 N IY S
juventude|ZH UW V T UW D ZH IY
juíza|ZH UW IY Z AE
já|ZH AE
jéssica|ZH EH S IY K AA
júlio|ZH UW L Y UW
júri|ZH UW R IY
k|K AE
kagoshima|K AE G OW0 SH IY M AA
kalevala|K AE L EH0 V AE L AA
kaminski|K AE M S K IY
kan|K AE N
kauê|K AE W EH0
kawaii|K AE W AE Y IY
kazatchok|K AE Z AE T AO K IY
khmer|K M EH RH
kiev|K IY EH V IY
kilimanjaro|K IY L IY M AA ZH AE R UW
kilobit|K IY L OW0 B IY T IY
kilobyte|K IY L OW0 B AE Y T SH IY
kirov|K IY R AO V
kit|K IY T
klinger|K L ZH EH HR
kombi|K B IY
kowalski|K OW0 V AE W S K IY
kwanza|K W AA Z AA
kyat|K IY AE T IY
la|L AE
laca|L AE K AA
lacra|L AE K R AA
lacro|L AE K R UW
lacônico|L AE K OW0 N IY K UW
lagartear|L AE G AE RH T Y AE RH
lahore|L AE HH AO R IY
laico|L AE Y K UW
laivo|L AE Y V UW
lambiam|L AA B IY AA W
lambida|L AA B IY D AA
lambo|L AA B UW
lambreta|L AA B R EH0 T AA
lambuzar|L AA B UW Z AE RH
lameira|L AE M EH0 Y R AA
lameiro|L AE M EH0 Y R UW
lamento|L AA M T UW
lamparina|L AA P AE R IY N AA
lampejo|L AA P EH ZH UW
lamúria|L AE M UW R Y AE
lancha|L AA SH AA
lanchar|L AA SH AE RRR
lanche|L SH IY
lanchou|L AA SH OW0 W
lande|L AA D IY
lanterninha|L AA T EH R N IY N IY0 AA
lança|L AA S AA
lanço|L AA S UW
lapa|L AE P AA
lapidar|L AE P IY D AE RH
laptop|L EH P T AO P
laquê|L AE K EH0
lara|L AE R AA
laranjeira|L AE R AA ZH EH0 Y R AA
largar|L AE HR G AE HR
largo|L AE RH G UW
las|L AA SH
lasca|L AE S K AA
lassa|L AE S AA
lasso|L AE S UW
lastimosa|L AE S T IY M AO Z AA
lata|L AE T AA
latam|L AE T AA W
latamos|L AE T AA M UW S
latas|L AE T AA S
late|L AE T IY
latem|L AE T Y
lates|L AE T IY S
lati|L AE T IY
latia|L AE T IY AA
latiam|L AE T IY AA W
latias|L AE T IY AA S
latimos|L AE T IY M UW S
latino|L AE T IY N UW
latira|L AE T IY R AA
latiram|L AE T IY R AA W
latiras|L AE T IY R AA S
latirei|L AE T IY R EH0 Y
latirem|L AE T IY R Y
latiremos|L AE T IY R EH0 M UW S
latires|L AE T IY R IY S
latiria|L AE T IY R IY AA
latiriam|L AE T IY R IY AA W
latirias|L AE T IY R IY AA S
latirmos|L AE T IY RH M UW S
latirá|L AE T IY R AE
latirás|L AE T IY R AE S
latirão|L AE T IY R AA W
latiríamos|L AE T IY R IY AA M UW S
latis|L AE T IY S
latisse|L AE T IY S IY
latissem|L AE T IY S Y
latisses|L AE T IY S IY S
latiste|L AE T IY S T IY
latiu|L AE T IY W
lato|L AE T UW
latíamos|L AE T IY AA M UW S
latíramos|L AE T IY R AA M UW S
latíssemos|L AE T IY S EH0 M UW S
laura|L AE W R AA
lava|L AE V AA
lavabo|L AE V AE B UW
lavar|L AE V AE RH
lavra|L AE V R AA
layout|L EH0 Y AE W T
laço|L AE S UW
lealdade|L EH0 AE W D AE D IY
led|L EH D
ledo|L EH0 D UW
legionário|L EH0 ZH Y OW0 N AE R Y UW
legislação|L EH0 ZH IY S L AE S AA W
legião|L EH0 ZH Y AA W
lego|L EH G UW
leila|L EH0 Y L AA
leira|L EH0 Y R AA
leite|L EH0 Y T SH IY
leitão|L EH0 Y T AA W
lembra|L B R AA
lembram|L B R AA W
lembrando|L B R AA D UW
lembrança|L B R AA S AA
lembrava|L B R AE V AA
lembro|L B R UW
lembrou|L B R OW0 W
lenda|L D AA
lendo|L D UW
lene|L EH0 N IY
leniência|L EH0 N IY S Y AE
lenta|L T AA
lentes|L T IY S
lento|L T UW
lentícula|L T IY K UW L AA
lenço|L S UW
lençol|L S AO W
leo|L EH W
leonardo|L EH0 OW0 N AE RH D UW
leonor|L EH0 W N OW0 RH
lepra|L EH P R AA
leque|L EH K IY
lera|L EH0 R AA
lesma|L EH0 ZH M AA
lesão|L EH0 Z AA W
letra|L EH0 T R AA
letrado|L EH0 T R AE D UW
letrinha|L EH0 T R IY N IY0 AA
leu|L EH0 W
leucemia|L EH0 W S EH0 M IY AA
leva|L EH V AA
levam|L EH V AA W
levantar|L EH0 V AA T AE RH
levo|L EH V UW
lewandowski|L EH0 V AA D AO V S K IY
lexicologia|L EH K S IY K OW0 L OW0 ZH IY AA
lhas|L IY AA Z
lhes|L IY IY S
li|L IY
liberação|L IY B EH0 R AE S AA W
liberrimamente|L IY B EH RH IY M AA M T IY
libra|L IY B R AA
libras|L IY B R AA S
libélula|L IY B EH L UW L AA
libérrimo|L IY B EH RH IY M UW
licantropo|L IY K AA T R OW0 P UW
licença|L IY S S AA
lichia|L IY SH IY AA
lidar|L IY D AE RH
liderar|L IY D EH0 R AE RH
liga|L IY G AA
ligado|L IY G AE D UW
ligar|L IY G AE RH
ligação|L IY G AE S AA W
light|L AE Y T
lilongwe|L IY L G W EH
lima|L IY M AA
limeira|L IY M EH0 Y R AA
limitado|L IY M IY T AE D UW
limitar|L IY M IY T AE RH
limoeiro|L IY M OW0 EH0 Y R UW
limpar|L P AE RH
limpeza|L P EH0 Z AA
limpo|L P UW
limão|L IY M AA W
limítrofe|L IY M IY T R OW0 F IY
linchava|L SH AE V AA
linda|L D AA
lindo|L D UW
lingala|L G AE L AA
lingerie|L AA ZH EH0 RH IY
linguiça|L G W IY S AA
linha|L IY N IY0 AA
linho|L IY N IY0 UW
lintel|L T EH W
liso|L IY Z UW
lista|L IY S T AA
listagem|L IY S T AE ZH Y
listra|L IY S T R AA
lisura|L IY Z UW R AE
literatura|L IY T EH0 R AE T UW R AA
litigar|L IY T SH IY G AE HR
litrosa|L IY T R AO Z AA
liverpool|L IY V EH0 RH P UW W
livrar|L IY V R AE RH
livraria|L IY V R AE R IY AA
livrava|L IY V R AE V AA
livreiro|L IY V R EH0 Y R UW
livremente|L IY V R IY M T IY
livrete|L IY V R EH0 T IY
livreto|L IY V R EH0 T UW
livro|L IY V R UW
livros|L IY V R UW S
livrão|L IY V R AA W
lixa|L IY SH AA
lixava|L IY SH AE V AA
lixo|L IY SH UW
lição|L IY S AA W
lo|L UW
lobista|L OW0 B IY S T AA
login|L AO G
logos|L OW0 G UW S
logística|L OW0 ZH IY SH T IY K AA
loiro|L OW0 Y R UW
loja|L AO ZH AA
lomba|L B AA
lombardo|L B AE RH D UW
lombo|L B UW
longa|L G AA
longanimidade|L G AA N IY M IY D AE D ZH IY
longo|L G UW
lontra|L T R AA
los|L UW SH
losango|L OW0 Z AA G UW
lotar|L OW0 T AE RH
lote|L AO T IY
lotear|L OW0 T IY AE R
louco|L OW0 W K UW
loucura|L OW0 W K UW R AA
loulé|L OW0 W L EH
louquear|L OW0 W K EH0 AE RH
lourenço|L OW0 W R S UW
louro|L OW0 W R UW
lousa|L OW0 W Z AA
louvar|L OW0 W V AE RH
louvava|L OW0 W V AE V AA
lua|L UW AA
lucas|L UW K AA S
luciano|L UW S Y AA N UW
lucrar|L UW K R AE RH
lucrava|L UW K R AE V AA
lucro|L UW K R UW
lugarzinho|L UW G AE Z N IY0 UW
lula|L UW L AA
lulopetismo|L UW L OW0 P EH0 T IY Z M UW
luminoso|L UW M IY N OW0 Z UW
luneta|L UW N EH0 T AA
lupa|L UW P AA
luso|L UW Z UW
lustre|L UW SH T R IY
luta|L UW T AA
lutar|L UW T AE RH
lutinha|L UW T IY N IY0 AA
luto|L UW T UW
luva|L UW V AA
luvaria|L UW V AE R IY AA
lux|L UW K S
luxo|L UW SH UW
luxúria|L UW SH UW R IY AA
luís|L UW IY SH
lá|L AE
lácio|L AE S Y UW
lápide|L AE P IY D IY
lápis|L AE P IY S
lázaro|L AE Z AE R UW
lâmina|L AA M IY N AA
lâmpada|L AA P AA D AA
lânguido|L AA G IY D UW
lã|L AA
léu|L EH W
lê|L EH0
língua|L G W AA
lípsia|L IY P S Y AA
líquido|L IY K W IY D UW
lírica|L IY R IY K AA
lírico|L IY R IY K UW
lírio|L IY R Y UW
lógico|L AO ZH IY K UW
lótus|L AO T UW S
lúcia|L UW S Y AA
lúcida|L UW S IY D AA
lúpulo|L UW P UW L UW
lútea|L UW T IY AA
ma|M AA
macarrão|M AE K AE RH AA W
macete|M AE S EH0 T SH IY
machadiano|M AE SH AE D Y AA N UW
machadinha|M AE SH AE D ZH IY N IY0 AE
machado|M AE SH AE D UW
machista|M AE SH IY S T AA
macho|M AE SH UW
macio|M AE S IY UW
macla|M AE K L AA
maconha|M AE K OW0 N IY0 AE
macro|M AE K R UW
macumba|M AE K B AA
madre|M AE D R IY
madressilva|M AE D R EH0 S IY W V AA
madruga|M AE D R UW G AA
madrugada|M AE D R UW G AE D AA
madrugar|M AE D R UW G AE RH
maduro|M AE D UW R UW
mafioso|M AE F Y OW0 Z UW
magistratura|M AA ZH IY SH T R AA T UW R AA
magistério|M AE ZH IY S T EH R Y UW
magnífico|M AE G N IY F IY K UW
magoar|M AE G W AE RH
maia|M AE Y AA
maio|M AE Y UW
maionese|M AE Y OW0 N EH Z IY
maioria|M AE Y OW0 R IY AA
maioridade|M AE Y OW0 R IY D AE D ZH IY
maisena|M AE Y Z EH0 N AE
maiô|M AE Y OW0
mala|M AE L AA
malandragem|M AE L AA D R AE ZH Y
malandrar|M AE L AA D R AE RH
malaquias|M AE L AE K IY AA S
maleficiar|M AE L EH0 F IY S IY AE HR
malefício|M AE L EH0 F IY S Y UW
maleta|M AE L EH0 T AA
malha|M AE L IY AA
malho|M AE L IY UW
mali|M AE L IY
maligno|M AE L IY G N UW
malina|M AE L IY N AA
malinha|M AE L IY N IY0 AA
malinhas|M AE L IY N IY0 AA S
maloca|M AE L AO K AE
malograr|M AE L OW0 G R AE RH
maloqueiro|M AE L OW0 K EH0 Y R UW
malsã|M AE W S AA
maltês|M AE W T EH0 Y SH
malásia|M AE L AE Z Y AA
malévola|M AE L EH V OW0 L AA
malévolo|M AE L EH V OW0 L UW
mamba|M AA B AA
mambembe|M AA B Y B IY
mambo|M AA B UW
mameluco|M AE M EH0 L UW K UW
mamilo|M AA M IY L UH
mamãe|M AA M AA Y
mamão|M AA M AA W
manada|M AE N AE D AA
manca|M AA K AA
mancar|M AA K AE RH
mancha|M AA SH AE
manche|M AA SH IY
manchester|M AA SH EH S T EH0 RH
manchete|M SH EH T SH IY
manchúria|M AA SH UW R Y AA
manco|M AA K UW
mancomunado|M K OW0 M UW N AE D UW
manda|M AA D AA
mandado|M AA D AE D UW
mandando|M AA D AA D UW
mandar|M AA D AE HR
mandato|M AA D AE T UW
mandatório|M AA D AE T AO R IY UW
mandava|M AA D AE V AA
mandinga|M D ZH G AE
mandingar|M D ZH G AE HR
mandingueiro|M D ZH G EH0 Y R UW
mando|M AA D UW
mandorla|M AA D AO R L AA
mandíbula|M AA D IY B UW L AA
maneira|M AA N EH R AA
maneirar|M AA N EH0 Y R AE R
maneirismo|M AA N EH0 Y R IY ZH M UW
maneiro|M AA N EH R UW
manga|M AA G AA
manganela|M AA G AE N EH L AA
mangra|M AA G R AA
mangue|M AA G IY
mangá|M AA G AE
manhoso|M AA N IY0 OW0 Z UW
manhê|M AA N IY0 EH0
manicômio|M AA N IY K OW0 M IY UW
manipulação|M AA N IY P UW L AE S AA W
manipulável|M AE N IY P UW L AE V EH0 W
manjar|M AA ZH AE RH
manjerico|M AA ZH EH0 R IY K UW
manjericão|M AA ZH EH0 R IY K AA W
manobra|M AA N AO B R AA
mansa|M AA S AA
mansidão|M AA S IY D AA W
manso|M AA S UW
mansão|M AA S AA W
manta|M AA T AA
manter|M AA T EH0 RH
manto|M AA T UW
mantém|M AA T Y
mantêm|M AA T Y
manumissão|M AA N UW M IY S AA W
manuscrito|M AA N UW S K R IY T UW
manusear|M AA N UW Z EH0 AE RH
maori|M AE OW0 R IY
maoísmo|M AE W IY Z M UW
mapa|M AE P AA
maputo|M AA P UW T UW
maquiavélico|M AE K Y AE V EH L IY K UW
maquilhagem|M AE K IY L IY AE ZH Y
maquinaria|M AE K IY N AE R IY AA
mara|M AE R AA
maracanaço|M AA R AE K AA N AE S UW
maracujá|M AE R AE K UW ZH AE
marambaia|M AE R AA B AE Y AA
maratona|M AE R AE T OW0 N AA
maravilhoso|M AE R AE V IY L IY OW0 Z UW
marca|M AE RH K AA
marcar|M AE RH K AE RH
marcha|M AE RH SH AA
marchar|M AE R SH AE RH
marco|M AE RH K UW
marcos|M AE RH K UW S
marga|M AE RH G AA
margarida|M AE RH G AE R IY D AA
maria|M AE R IY AA
marina|M AE R IY N AA
marinheiro|M AE R IY N IY0 EH0 Y R UW
marinho|M AE R IY N IY0 UW
mariposa|M AE R IY P OW0 Z AA
marketing|M AE RH K EH0 T SH
marmita|M AE RH M IY T AA
maromba|M AE R B AE
marquês|M AE R K EH0 IY SH
marra|M AE RH AE
marrano|M AE RH AA N UW
marreca|M AA RH EH K UW
marreco|M AA RH EH K UW
marreta|M AE RH EH T AA
marretada|M AE RH EH0 T AE D AA
marretar|M AE RH EH0 T AE RH
marretinha|M AE RH EH0 T IY N IY0 AA
marretão|M AE RH EH0 T AA W
marrom|M AE RH
marta|M AE RH T AA
martelo|M AE RH T EH L UW
marujo|M AE R UW ZH UW
marxista|M AE R K S IY S T AE
maré|M AE R EH
massa|M AE S AA
massachusetts|M AE S AE SH UW S EH0 T S
massificar|M AE S IY F IY K AE RH
massificação|M AE S IY F IY K AE S AA W
mastro|M AE SH T R UW
masturbação|M AE S T UW RH B AE S AA W
mata|M AE T AA
matador|M AE T AE D OW0 RH
matamatá|M AE T AE M AE T AE
matar|M AE T AE RH
matear|M AE T Y AE RH
matei|M AE T EH0 Y
mateus|M AE T EH0 W S
matias|M AE T IY AA S
matilda|M AE T IY W D AA
matilde|M AE T IY W D IY
matinê|M AE T IY N EH0
matiz|M AE T IY S
mato|M AE T UW
matriz|M AE T R IY S
matéria|M AE T EH R Y AA
mau|M AE W
maura|M AE W R AA
mauro|M AE W R UW
mavioso|M AE V IY OW0 Z UW
maxila|M AE K S IY L AE
mazela|M AE Z EH L AA
maça|M AE S AA
maço|M AE S UW
mc|M EH K IY
meação|M IY AE S AA W
mec|M EH K IY
meca|M EH K AA
medicina|M EH0 D IY S IY N AA
medida|M IY D ZH IY D AA
mediterrâneo|M EH0 D IY T EH0 RH AA N Y UW
medo|M EH0 D UW
medonho|M EH0 D OW0 N IY0 UW
medrica|M EH0 D R IY K AE
medricas|M EH0 D R IY K AE S
medrincas|M EH0 D R K AE S
medronho|M EH0 D R OW0 N IY0 UW
medroso|M EH0 D R OW0 Z UW
medíocre|M EH0 D IY W K R IY
megabit|M EH G AE B IY T IY
megabyte|M EH G AE B AE Y T SH IY
meio|M EH0 Y UW
melancia|M EH0 L AA S IY AA
melecar|M EH0 L EH0 K AE HR
melhorar|M EH0 L IY OW0 R AE RH
melhores|M EH0 L IY AO R IY SH
melhorzinho|M EH0 L IY AO RH Z IY N IY0 UW
meliante|M EH0 L IY T SH IY
melindre|M EH0 L D R IY
melindroso|M EH0 L D R OW0 Z UW
melodia|M EH0 L OW0 D IY AA
membrana|M B R AA N AA
membro|M B R UW
memória|M EH0 M AO R Y AA
mencionar|M S Y OW0 N AE RH
mendaz|M EH0 N D AE Y SH
mendigo|M D IY G UW
mene|M EH0 N IY
mengão|M G AA W
menina|M IY N IY N AA
menino|M IY N IY N UW
menores|M EH0 N AO R IY SH
mensagem|M S AE ZH Y
mensalidade|M S AE L IY D AE D ZH IY
mensuração|M S UW R AE S AA W
menta|M T AA
mentalidade|M T AE L IY D AE D IY
mentecapto|M T EH0 K AE P T UW
mentira|M T IY R AA
mentiroso|M T IY R OW0 Z UW
mera|M EH R AA
mercado|M EH0 RH K AE D UW
mercadologicamente|M EH0 RH K AE D OW0 L AO ZH IY K AA M T IY
mercadológico|M EH0 RH K AE D OW0 L AO ZH IY K UW
merchan|M EH0 RH SH
meristema|M EH0 R IY S T EH0 M AA
merlin|M EH RH L
merluza|M EH RH L UW Z AA
merreca|M EH0 RH EH K AE
mesa|M EH0 Z AA
mesopotâmia|M EH0 Z OW0 P OW0 T AA M IY AA
mesosfera|M EH0 Z OW0 S F EH R AE
messina|M EH0 S IY N AA
mestra|M EH S T R AA
mesóclise|M EH0 Z AO K L IY Z IY
meta|M EH T AA
metacarpal|M EH T AE K AE P AE W
metade|M EH0 T AE D IY
metafisicamente|M EH T AE F IY Z IY K AA M T IY
metaleiro|M EH0 T AE L EH0 Y R UW
mete|M EH T SH IY
meter|M EH0 T EH0
metido|M EH0 T SH IY D UW
metodicamente|M EH0 T AO D IY K AA M T IY
metodista|M EH0 T OW0 D ZH IY S T AA
metodologia|M EH T OW0 D OW0 L OW0 ZH IY AA
metro|M EH T R UW
metálica|M EH0 T AE L IY K AA
meu|M EH0 W
meço|M EH S UW
mi|M IY
miami|M AE Y AA M IY
miasma|M Y AE Z M AA
micaías|M IY K AE IY AA S
micho|M IY SH UW
mico|M IY K UW
micáceo|M IY K AE S IY UW
migrante|M IY G R AA T IY
migrar|M IY G R AE RH
migratório|M IY G R AE T AO R IY UW
migração|M IY G R AE S AA W
migué|M IY G EH
mijo|M IY ZH UW
mika|M IY K AA
miki|M IY K IY
mikiko|M IY K IY K UW
milha|M IY L IY AA
milhares|M IY L IY AE R IY S
milho|M IY L IY UW
milhão|M IY L IY AA W
miliciano|M IY L IY S Y AA N UW
militar|M IY L IY T AE RH
milão|M IY L AA W
mim|M
mimimi|M IY M IY M IY
mimo|M IY M UW
mimosa|M IY M AO Z AA
minako|M IY N AE K UW
mingau|M G AE W
ministro|M IY N IY SH T R UW
ministério|M IY N IY S T EH R Y UW
minsk|M S K
minuto|M IY N UW T UW
minúcia|M IY N UW S Y AE
minúsculo|M IY N UW S K UW L UW
miojo|M IY OW0 ZH UW
miosótis|M IY OW0 S AO T IY S
mira|M IY R AA
miraculoso|M IY R AA K UW L OW0 Z UW
miragem|M IY R AE ZH Y
miranda|M IY R AA D AA
mirandela|M IY R AA D EH L AA
mirandês|M IY R AA D EH0 Y SH
miriam|M IY R Y AA
mirra|M IY RH AA
mirrar|M IY RH AE RH
miráculo|M IY R AE K UW L UW
miríade|M IY R IY AE D IY
misandria|M IY Z AA D R IY AA
miserrimamente|M IY Z EH RH IY M AA M T IY
missa|M IY S AA
missionária|M IY S Y OW0 N AE R Y AA
mississippi|M IY S IY S IY P IY
missiva|M IY S IY V AA
missão|M IY S AA W
mister|M IY S T EH R
mistura|M IY S T UW R AA
misturar|M IY S T UW R AE RH
misturo|M IY SH T UW R UW
misérrimo|M IY Z EH RH IY M UW
mito|M IY T UW
mitocôndria|M IY T OW0 K D R Y AA
mitombo|M IY T B UW
mixuruca|M IY SH UW R UW K AE
miyuki|M IY Y UW K IY
miópico|M IY AO P IY K UW
mnemônico|M IY N EH0 M N IY K UW
mo|M UW
moacir|M OW0 AE S IY RH
mobelha|M OW0 B EH0 L IY AA
mobilidade|M OW0 B IY L IY D AE D IY
mobilizador|M OW0 B IY L IY Z AE D OW0 R
mocho|M OW0 SH UW
moda|M AO D AA
modalidade|M OW0 D AE L IY D AE D IY
modelo|M OW0 D EH0 L UW
moderar|M OW0 D EH0 R AE RH
moderno|M OW0 D EH RH N UW
modo|M AO D UW
mofo|M OW0 F UW
mogadishu|M OW0 G AE D IY SH UW
moinha|M OW0 IY N IY0 AE
moira|M OW0 Y R AA
moirama|M OW0 Y R AA M AA
moita|M OW0 Y T AA
mola|M AO L AA
molde|M AO W D ZH IY
moldura|M OW0 W D UW R AA
moleque|M UW L EH K IY
molequinho|M UW L EH K IY N IY0 UW
moleza|M OW0 L EH0 Z AA
molhada|M OW0 L IY AE D AA
molhadela|M OW0 L IY AE D EH L AA
molhadura|M OW0 L IY AE D UW R AA
molhagem|M OW0 L IY AE ZH Y
molhamento|M OW0 L IY AE M T UW
molho|M AO L IY UW
molhável|M OW0 L IY AE V EH0 W
molosso|M OW0 L OW0 S UW
momento|M OW0 M T UW
momice|M OW0 M IY S IY
mongol|M G AO W
mongoloide|M G OW0 L AO Y D IY
monitorar|M OW0 N IY T OW0 R AE RH
monja|M ZH AA
monogamia|M OW0 N OW0 G AA M IY AE
monogâmico|M OW0 N OW0 G AA M IY K UW
monstruoso|M S T R UW OW0 Z UW
montar|M T AE RH
monte|M T IY
monturo|M T UW R UW
monumento|M OW0 N UW M T UW
monádico|M OW0 N AE D IY K UW
monárquico|M OW0 N AE RH K IY K UW
monção|M S AA W
moo|M OW0 UW
moqueca|M UW K EH K AA
mora|M AO R AA
morada|M OW0 R AE D AA
moraes|M OW0 R AE Y S
morais|M OW0 R AE Y S
moranga|M UW R AA G AA
moratória|M OW0 R AE T AO R Y AA
morder|M OW0 RH D EH0 RH
mordóvia|M OW0 RH D AO V IY AA
more|M AO R IY
moreno|M OW0 R EH0 N UW
morista|M OW0 RRR IY S T AA
mormente|M AO RH M T IY
moro|M OW0 RRR UW
morre|M AO RH IY
morrendo|M OW0 RH D UW
morrinhenta|M OW0 RH IY N IY0 T AE
mortadela|M OW0 RH T AA D EH L AA
morte|M AO HR T IY
mortiça|M OW0 RH T IY S AA
mosca|M OW0 SH K AE
moscou|M OW0 SH K OW0 W
mosquito|M UW SH K IY T UH
mosteiro|M OW0 S T EH0 Y R UW
mostra|M AO S T R AA
mostram|M AO S T R AA W
mostrar|M OW0 S T R AE RH
motor|M OW0 T OW0 RH
mouco|M OW0 W K UW
moura|M OW0 W R AA
mourama|M OW0 W R AA M AA
mouro|M OW0 W R UW
mourão|M OW0 W R AA W
mouse|M AE W Z IY
move|M AO V IY
mover|M OW0 V EH0 RH
movimento|M OW0 V IY M T UW
moça|M OW0 S AA
moço|M OW0 S UW
moção|M OW0 S AA W
moésia|M OW0 EH Z Y AA
muda|M UW D AA
mudar|M UW D AE RH
mudo|M UW D UW
mufti|M UW F T IY
mui|M Y
muita|M Y T AA
muitas|M Y T AA S
muito|M Y T UW
muitos|M Y T UW S
muitíssimo|M Y T IY S IY M UW
mula|M UW L AA
mulato|M UW L AE T UW
mulherengo|M UW L IY EH R G UW
mulherzinha|M UW L IY EH Z N IY0 AA
mulherão|M UW L IY EH R AA W
multidão|M UW W T IY D AA W
multilíngue|M UW W T IY L G W IY
multiúso|M UW W T SH IY UW Z UW
mundo|M D UW
mundão|M D AA W
município|M UW N IY S IY P Y UW
munir|M UW N IY R
muquifo|M UW K IY F UW
muralha|M UW R AE L IY AA
muro|M UW R UW
musa|M UW Z AA
museu|M UW Z EH0 W
musicista|M UW Z IY S IY SH T AA
mussumê|M UW S UW M EH0
mustafá|M UW S T AE F AE
mutar|M UW T AE R
mutação|M UW T AE S AA W
mutuca|M UW T UW K AA
muçulmano|M UW S UW W M AA N UW
muçununga|M UW S UW N G AA
má|M AE
mácula|M AE K UW L AA
máfia|M AE F Y AA
mágica|M AE ZH IY K AA
mágico|M AE ZH IY K UW
mágoa|M AE G W AA
máquina|M AE K IY N AA
mártir|M AE RH T IY RH
máscara|M AE SH K AE R AA
máximo|M AE S IY M UW
mântua|M AA T UW AA
mãe|M AA Y
mão|M AA W
média|M EH D Y AA
médici|M EH D IY S IY
médico|M EH D IY K UW
mérito|M EH R IY T UW
mésia|M EH Z IY AA
método|M EH T OW0 D UW
méxico|M EH SH IY K UW
míssil|M IY S IY W
míster|M IY S T EH0 R
mó|M AO
mô|M OW0
música|M UW Z IY K AA
músico|M UW Z IY K UW
nababesco|N AE B AE B EH0 S K UW
nababo|N AE B AE B UW
nabucodonosor|N AE B UW K OW0 D OW0 N OW0 Z OW0 RH
nachos|N AE T UW SH
naco|N AE K UW
nadar|N AE D AE RH
nadir|N AE D IY RH
nagasaki|N AE G AE Z AE K IY
naifa|N AE Y F AA
nairobi|N AE Y R AO B IY
naja|N AE ZH AE
namespace|N EH0 Y M S P EH0 Y S IY
namoro|N AE M AO R UW
nananinanão|N AA N AA N IY N AE N AA W
nanquim|N AA K
napolitano|N AE P UW L IY T AA N UW
naquela|N AE K EH L AA
naquelas|N AE K EH L AA S
naquele|N AE K EH0 L IY
naqueles|N AE K EH0 L IY S
naquilo|N AE K IY L UW
narguilé|N AE RH G IY L EH
narina|N AE R IY N AA
narrativa|N AE RH AE T IY V AA
nasa|N AE Z AA
nascimento|N AE S IY M T UW
nascituro|N AE S IY T UW R UW
nasça|N AE S AA
nasço|N AE S UW
nata|N AE T AA
natalino|N AE T AE L IY N UW
naturalidade|N AE T UW R AE L IY D AE D IY
natureza|N AE T UW R EH0 Z AA
natália|N AE T AE L Y AA
natã|N AE T AA
nau|N AE W
nauseabunda|N AE W Z Y AE B D AA
nauta|N AE W T AA
navajo|N AE V AE ZH UW
navio|N AE V IY W
naxos|N AE K S UW S
nazca|N AE S K AA
nazi|N AE Z IY
nazismo|N AE Z IY Z M UW
nação|N AE S AA W
neandertal|N Y AA D EH0 RH T AE W
necessidade|N EH0 S EH0 S IY D AE D IY
necessitar|N EH0 S EH0 S IY T AE RH
necessário|N EH0 S EH0 S AE R Y UW
nefelibata|N EH0 F EH0 L IY B AE T AA
nega|N EH0 G AA
negativo|N EH0 G AE T SH IY V UW
negação|N EH0 G AE S AA W
negligenciável|N EH0 G L IY ZH S Y AE V EH0 W
nego|N EH0 G UW
negociar|N EH0 G OW0 S IY AE RH
negus|N EH G UW S
negão|N EH0 G AA W
nela|N EH L AA
nelas|N EH L AA S
nele|N EH0 L IY
neles|N EH0 L IY S
nelson|N EH W S
nenenzinho|N EH0 N Y Z IY N IY0 UW
nenhuma|N EH0 N IY0 AA
neném|N EH0 N Y
neozelandês|N EH W Z EH0 L AA D EH0 Y S
nepotismo|N EH0 P OW0 T IY Z M UW
nerd|N EH RH D IY
neri|N EH0 R IY
nero|N EH R UW
nervosa|N EH0 RH V AO Z AA
nervoso|N EH0 RH V OW0 Z UW
nervosos|N EH0 RH V AO Z UW S
nessa|N EH S AA
nessas|N EH S AA S
nesse|N EH0 S IY
nesses|N EH0 S IY S
nesta|N EH S T AA
nestas|N EH S T AA S
neste|N EH0 S T IY
nestes|N EH0 S T IY S
neta|N EH T AA
neto|N EH T UW
neurocirurgia|N EH0 W R OW0 S IY R UW RH ZH IY AA
neurológica|N EH0 W R OW0 L AO ZH IY K AA
neurológico|N EH0 W R OW0 L AO ZH IY K UW
neurónio|N EH0 W R OW0 N Y UW
neve|N EH V IY
nevrálgico|N EH0 V R AE W ZH IY K UW
newcastle|N IY W K EH S OW0 W
nheengatu|N IY0 G AE T UW
nhoca|N IY0 AO K AA
nicho|N IY SH UW
nigérrimo|N IY ZH EH RH IY M UW
nilo|N IY L UW
nim|N
nimbo|N B UW
nina|N IY N AA
ninfa|N F AA
ninguém|N G Y
ninho|N IY N IY0 UW
ninjete|N ZH EH T SH IY
nipófilo|N IY P AO F IY L UW
nisso|N IY S UW
nisto|N IY S T UW
nix|N IY K S
no|N UW
nobre|N AO B R IY
nobélio|N OW0 B EH L IY UW
nocautear|N OW0 K AE W T IY AE RH
noemi|N OW0 EH0 M IY
noia|N AO Y AA
noiva|N OW0 Y V AA
noivinha|N OW0 Y V IY N IY0 AA
noivo|N OW0 Y V UW
nojeira|N OW0 ZH EH0 Y R AE
nojo|N OW0 ZH UW
nomear|N OW0 M IY AE RH
nominativo|N OW0 M IY N AE T IY V UW
nona|N OW0 N AA
nop|N AO P
nora|N AO R AA
nordeste|N AO D EH SH T IH
norma|N AO RH M AA
nortúmbria|N OW0 RH T B R IY AA
norueguês|N OW0 R UW EH0 G EH0 Y SH
nosocômio|N AO Z AO K OW0 M IY UW
nossa|N AO S AA
nosso|N AO S UW
nota|N AO T AA
note|N AO T IY
notebook|N AO T IY B UW K IY
noticiário|N OW0 T IY S IY AE R Y UW
notícia|N OW0 T IY S Y AA
noutro|N OW0 W T R UW
nova|N AO V AA
novaes|N OW0 V AE Y S
novais|N OW0 V AE Y S
novato|N OW0 V AE T UW
novela|N OW0 V EH L AA
noveleiro|N OW0 V EH0 L EH0 Y R UW
novembro|N AO V B R UW
novidade|N OW0 V IY D AE D ZH IY
novinha|N AO V IY N IY0 AA
noviço|N OW0 V IY S UW
novo|N OW0 V UW
novíssima|N AO V IY S IY M AA
noção|N OW0 S AA W
noé|N OW0 EH
nu|N UW
nua|N UW AA
nuca|N UW K AA
nuclear|N UW K L EH0 AE RH
nulidade|N UW L IY D AE D ZH IY
num|N
numa|N UW M AA
numas|N UW M AA SH
numera|N UW M EH R AA
numero|N UW M EH R UW
numeroso|N UW M EH0 R OW0 Z UW
numérico|N UW M EH R IY K UW
nunca|N K AA
nuns|N SH
nupcial|N UW P S Y AE W
nutella|N UW T EH L AA
nylon|N AE Y L
nyx|N IY K S
nágua|N AE G W AE
nápoles|N AE P OW0 L IY S
não|N AA W
né|N EH
néscio|N EH S Y UW
nível|N IY V EH0 W
nó|N AO
nóbrega|N AO B R EH0 G AE
nós|N AO S
núbil|N UW B IY W
número|N UW M EH0 R UW
obediência|OW0 B EH0 D Y S IY AA
obeso|OW0 B EH Z UW
objete|OW0 B ZH EH T SH IY
objetividade|OW0 B ZH EH0 T IY V IY D AE D IY
objetivo|OW0 B ZH EH0 T SH IY V UW
objeto|OW0 B ZH EH T UW
objeção|OW0 B IY ZH EH0 S AA W
obnubilado|OW0 B N UW B IY L AE D UW
oboé|OW0 B OW0 EH
obrigada|OW0 B R IY G AE D AA
obrigatoriedade|OW0 B R IY G AE T OW0 R IY EH0 D AE D IY
obsceno|AO P S EH0 N UW
obscuro|OW0 B S K UW R UW
obsequiar|OW0 B Z EH0 K IY AE HR
observar|AO B S EH V AE HH
obsessão|OW0 B S EH0 S AA W
obstante|AO P S T AA T IY
obstinada|OW0 B S T IY N AE D AA
obter|OW0 B T EH0 RH
obtuso|OW0 B T UW Z UW
oca|AO K AA
ocarina|OW0 K AA R IY N AA
ocasião|OW0 K AE Z IY AA W
occipital|OW0 K S IY P IY T AE W
occitano|OW0 K S IY T AA N UW
oceania|OW0 S EH0 AA N IY AA
oceano|OW0 S IY AA N UW
oceânico|OW0 S IY AA N IY K UW
ocioso|OW0 S Y OW0 Z UW
oco|OW0 K UW
odeiam|OW0 D EH0 Y AA W
odin|OW0 D
odor|OW0 D OW0 RH
oftalmo|OW0 F T AE W M UW
oftalmologista|OW0 F T AE W M OW0 L OW0 ZH IY S T AA
oftalmologistas|OW0 F T AE W M OW0 L OW0 ZH IY S T AA S
ofídio|OW0 F IY D OW0
oi|OW0 Y
oie|OW0 Y EH0
oitava|OW0 Y T AE V AA
oitavo|OW0 Y T AE V UW
oitenta|OW0 Y T T AA
oito|OW0 Y T UW
oiço|OW0 Y S UW
ok|OW0 K EH0 Y
ola|OW0 L AA
olaria|AO L AA R IY AA
olha|AO L IY AA
olhada|OW0 L IY AE D AA
olhado|OW0 L IY AE D UW
olham|AO L IY AA W
olhamos|OW0 L IY AA M UW S
olhando|OW0 L IY AA D UW
olhara|OW0 L IY AE R AA
olharam|OW0 L IY AE R AA W
olharei|OW0 L IY AE R EH0 Y
olharia|OW0 L IY AE R IY AA
olhará|OW0 L IY AE R AE
olhaste|OW0 L IY AE S T IY
olhava|OW0 L IY AE V AA
olhei|OW0 L IY EH0 Y
olhinho|OW0 L IY IY N IY0 UW
olhinhos|AO L IY IY N IY0 UW S
olho|AO L IY UW
olhou|OW0 L IY OW0 W
olhão|OW0 L IY AA W
olhões|AO L IY Y S
oliveira|OW0 L IY V EH0 Y R AA
olivina|OW0 L IY V IY N AA
olivério|OW0 L IY V EH R Y UW
olá|AO L AE
omaha|OW0 M AE HH AA
ombro|B R UW
omitir|OW0 M IY T SH IY RH
omoplata|OW0 M OW0 P L AE T AE
onda|D AA
onera|OW0 N EH R AA
ong|G IY
onisciência|OW0 N IY S IY S IY AA
online|L AE Y N IY
onomatopeia|OW0 N OW0 M AE T OW0 P EH Y AA
onomástico|OW0 N OW0 M AE S T IY K UW
onça|S AA
operário|AO P EH R AE R Y UW
opróbrio|OW0 P R AO B R IY UW
opção|OW0 P S AA W
ora|AO R AA
ordenar|AO D N AE HH
ordenhar|OW0 R D N IY0 AE R
orelhudo|OW0 R EH0 L IY UW D UW
orelhão|OW0 R EH0 L IY AA W
original|OW0 R IY ZH IY N AE W
oriundo|OW0 R Y D UW
orixá|OW0 R IY SH AE
orkuteiro|OW0 RH K UW T EH0 Y R UW
orlando|OW0 RH L AA D UW
orquídea|AO RH K IY D IY AA
orégano|OW0 R EH G AA N UW
os|UW S
osaka|OW0 Z AE K AA
osasquense|OW0 Z AE S K S IY
osso|OW0 S UW
otaku|OW0 T AE K UW
oto|AO T UW
ottawa|OW0 T AE W AA
ou|OW0 W
ourela|OW0 W R EH L AE
ourives|OW0 W R IY V IY S
ouriço|OW0 W R IY S UW
ouro|OW0 W R UW
outdoor|AE W T D AO R
outra|OW0 W T R AA
outro|OW0 W T R UW
ouvi|OW0 W V IY
ouvido|OW0 W V IY D UW
ouvidoria|OW0 W V IY D OW0 R IY AA
ouviu|OW0 W V IY W
ova|AO V AA
ovar|OW0 V AE R
ovnilogia|AO V N IY L OW0 ZH IY AE
ovo|OW0 V UW
oxe|OW0 SH IY
oxigênio|AO K S IY ZH EH0 N Y UW
oxiúro|OW0 K S IY UW R UW
oásis|OW0 AE Z IY S
pabulagem|P AE B UW L AE ZH Y
paciente|P AE S Y T IY
pacientes|P AE S Y T IY S
pacotilha|P AE K OW0 T IY L IY AA
pacóvio|P AE K AO V Y UW
padecer|P AE D EH0 S EH0 RH
padecestes|P AE D EH0 S EH0 S T IY S
padeiro|P AE D EH0 Y R UW
padilha|P AE D IY L IY AA
padoca|P AE D AO K AE
padrão|P AE D R AA W
pagando|P AE G AA D UW
pagode|P AE G AO D IY
pagão|P AE G AA W
pai|P AE Y
paio|P AE Y UW
paisagem|P AE Y Z AE ZH Y
paitrocínio|P AE Y T R OW0 S IY N Y UW
paixão|P AE Y SH AA W
paizinho|P AE Y Z IY N IY0 UW
paizão|P AE Y Z AA W
pajubá|P AE ZH UW B AE
pala|P AE L AA
palanca|P AE L AA K AA
palanquim|P AE L AA K
palato|P AE L AE T UW
palauano|P AE L AE W AA N UW
palavra|P AE L AE V R AA
palavras|P AE L AE V R AA S
palavrinha|P AE L AE V R N IY0 AA
palavrão|P AE L AE V R AA W
palear|P AA L Y AE R
palermo|P AE L EH RH M UW
palha|P AE L IY AA
paliativo|P AE L Y AE T IY V UW
palito|P AE L IY T UW
palácio|P AE L AE S Y UW
palíndromo|P AA L D RRR UW M UW
panca|P AA K AA
panda|P AA D AA
pandeiro|P AA D EH0 Y R UW
pandeísta|P AA D EH0 IY S T AA
pandora|P AA D AO R AA
pane|P AA N IY
panela|P AA N EH L AA
panetone|P AA N EH0 T OW0 N IY
panfleto|P AA F L EH0 T UW
panqueca|P AA K EH K AA
pantera|P AA T EH R AA
panteísta|P AA T EH0 IY S T AA
pantomima|P AA T UW M IY M AA
panturrilha|P AA T UW RH IY L IY AA
pança|P AA S AA
papa|P AE P AA
papagaio|P AE P AE G AE Y UW
papai|P AE P AE Y
paparazzo|P AE P AE R AE T S UW
paparicho|P AE P AE R IY SH UW
paparrotão|P AE P AE RH OW0 T AA W
papelão|P AE P IY L AA W
papila|P AE P IY L AA
papo|P AE P UW
papoula|P AE P OW0 W L AA
papão|P AA P AA W
paquerar|P AE K EH0 R AE RH
para|P AE R AA
paracelso|P AE R AE S EH W S UW
paracetamol|P AE R AE S EH0 T AE M AO W
paradigma|P AE R AE D IY G M AA
parado|P AE R AE D UW
parafusado|P AE R AE F UW Z AE D UW
parafuso|P AE R AE F UW Z UW
parapeito|P AE R AE P EH0 Y T UW
paraquedas|P AE R AE K EH D AA S
paraíso|P AE R AE IY Z UW
parceiro|P AE RH S EH0 Y R UW
parcelar|P AE RH S EH0 L AE RH
pardo|P AE RH D UW
pare|P AE R IY
parece|P AE R EH S IY
parecido|P AE R EH0 S IY D UW
parede|P AE R EH0 D IY
paredão|P AE R EH0 D AA W
parestesia|P AE R EH0 SH T EH0 Z IY AE
pareço|P AE R EH0 S UW
parideira|P AE R IY D EH0 Y R AA
parietal|P AE R Y EH0 T AE W
paritária|P AE R IY T AE R IY AA
parkour|P AE RH K UW RH
parlapatice|P AE R L AE P AE T SH IY S IY
parlapatão|P AE R L AE P AE T AA W
parque|P AE RH K IY
parra|P AE RH AE
parrudo|P AE RH UW D UW
partezinha|P AE HH T IY Z N IY0 AA
participar|P AE RH T IY S IY P AE RH
particípio|P AE RH T IY S IY P IY UW
partida|P AE RH T SH IY D AA
partido|P AE RH T IY D UW
partidário|P AE RH T IY D AE R IY UW
partir|P AE RH T IY RH
partirmos|P AE RH T IY RH M UW S
pascácio|P AE S K AE S Y UW
paspalho|P AA SH P AE L IY UW
passa|P AE S AA
passado|P AE S AE D UW
passagem|P AE S AE ZH Y
passaralho|P AA S AA RRR AA L IY UW
passaram|P AE S AE R AA W
passeata|P AE S IY AE T AA
passeio|P AE S EH0 Y UW
passo|P AE S UW
passou|P AE S OW0 W
pastando|P AE S T AA D UW
pastelaria|P AE SH T EH0 L AE R IY AE
pasto|P AE SH T UW
pastor|P AE S T OW0 RH
pasárgada|P AE Z AE RH G AE D AA
patada|P AE T AE D AA
patas|P AE T AA S
patela|P AE T EH L AE
patesca|P AE T EH0 S K AA
patinete|P AE T SH IY N EH T SH IY
pato|P AE T UW
patológica|P AE T OW0 L AO ZH IY K AA
patológicas|P AE T OW0 L AO ZH IY K AA S
patológicos|P AE T OW0 L AO ZH IY K UW S
patopolitano|P AE T OW0 P OW0 L IY T AA N UW
patota|P AE T AO T AA
patrazana|P AE T R AE Z AA N AE
patriarca|P AE T R IY AE RH K AA
patriarcado|P AE T R IY AE RH K AE D UW
patrocínio|P AE T R OW0 S IY N Y UW
patrola|P AE T R AO L AA
patrono|P AE T R OW0 N UW
patrícia|P AE T R IY S Y AA
patrício|P AE T R IY S Y UW
patético|P AE T EH T IY K UW
patê|P AE T EH0
patópolis|P AE T AO P OW0 L IY S
pau|P AE W
paula|P AE W L AA
paulo|P AE W L UW
pausa|P AE W Z AA
pausar|P AE W Z AE RH
pauso|P AE W Z UW
pauta|P AE W T AA
pavê|P AE V EH0
pavês|P AE V EH0 S
pazes|P AE Z IY SH
paço|P AE S UW
paúra|P AE UW R AA
pc|P EH0 S EH0
pebol|P EH B AO W
pec|P EH K IY
peca|P EH K AA
pedacinho|P EH0 D AE S IY N IY0 UW
pedagogia|P EH0 D AE G OW0 ZH IY AA
pedido|P EH0 D IY D UW
pedonal|P EH0 D OW0 N AE W
pedra|P EH D R AA
pedreira|P EH0 D RRR EH0 Y R AA
pedreiro|P EH0 D R EH0 Y R UW
pedro|P EH0 D R UW
pegajosa|P EH0 G AE ZH AO Z AA
peguete|P EH0 G EH T SH IY
peitinho|P EH0 Y T IY N IY0 UW
pela|P EH L AA
pelas|P EH0 L AA S
pelicano|P EH0 L IY K AA N UW
pelo|P EH L UW
pelos|P EH0 L UW S
pelourinho|P EH0 L OW0 W R IY N IY0 UW
pelouro|P EH0 L OW0 W R UW
pelve|P EH W V IY
película|P EH0 L IY K UW L AA
pelúcia|P EH0 L UW S Y AE
pendurar|P D UW R AE RH
pendão|P D AA W
penicilina|P EH0 N IY S IY L IY N AA
penico|P IY N IY K UW
peninsular|P EH0 N S UW L AE R
penitência|P EH0 N IY T S IY AA
penosa|P EH0 N AO Z AA
pensa|P S AA
pensador|P S AE D OW0 RH
pensam|P S AA W
pensamento|P S AA M T UW
pensando|P S AA D UW
pensara|P S AE R AA
pensaram|P S AE R AA W
pensativo|P S AE T IY V UW
pensava|P S AE V AA
penso|P S UW
pensoso|P S OW0 Z UW
pensou|P S OW0 W
pensão|P S AA W
penteado|P T Y AE D UW
pepineiro|P EH0 P IY N EH0 Y R UW
pequenininho|P IY K IY N IY N N IY0 UW
pequeno|P IY K N UW
pera|P EH R AA
perambulava|P EH0 R AA B UW L AE V AE
peraí|P EH R AE IY
perca|P EH0 R K AA
percebem|P EH0 RH S EH B Y
perceber|P EH0 RH S EH0 B EH0 RH
percorrer|P EH0 RH K OW0 RH EH0 RH
perda|P EH0 RH D AA
perdição|P EH0 RH D ZH IY S AA W
perdoar|P EH0 RH D OW0 AE RH
perdulário|P EH0 R D UW L AE R Y UW
perdão|P EH0 RH D AA W
perecibilidade|P EH0 RRR EH0 S IY B IY L IY D AE D ZH IY
perene|P EH0 R EH0 N IY
perfilar|P EH0 RH F IY L AE RH
periférica|P EH0 R IY F EH R IY K AA
perigo|P EH0 R IY G UW
perigosas|P EH0 R IY G AO Z AE S
perigoso|P IY R IY G OW0 Z UW
perito|P EH0 R IY T UW
permanecer|P EH0 RH M AA N EH0 S EH0 RH
permanente|P EH0 RH M AA N T SH IY
permitir|P EH0 HR M IY T IY HR
pernambucano|P EH0 RH N AA B UW K AA N UW
pernóstico|P EH0 R N AO S T SH IY K UW
pero|P EH R UW
perplexo|P EH0 RH P L EH K S UW
perro|P EH0 RH UW
perscrutar|P EH0 HR S K R UW T AE RH
perseguir|P EH0 RH S EH0 G IY RH
persuadir|P EH0 RH S W AE D ZH IY RH
persépolis|P EH0 RH S EH P OW0 L IY S
pertencer|P EH0 RH T S EH0 RH
pertinente|P EH0 RH T SH IY N T SH IY
perturbador|P EH0 RH T UW RH B AE D OW0 RH
perturbar|P EH0 RRR T UW RRR B AE RRR
peru|P IY R UW
perversão|P EH0 RH V EH0 RH S AA W
período|P EH0 R IY W D UW
pesa|P EH Z AA
pesado|P EH0 Z AE D UW
pesagem|P EH0 Z AE ZH Y
pesca|P EH S K AA
pescador|P EH0 SH K AE D OW0 RH
pescoço|P EH0 SH K OW0 S UW
peshmerga|P EH SH IY M EH RH G AA
peso|P EH Z UW
pesquisa|P EH0 S K IY Z AA
pesquisar|P EH0 S K IY Z AE RH
pessoa|P EH S OW0 AE
pestana|P EH0 SH T AA N AA
peste|P EH S T IY
pet|P EH T
peteminion|P EH0 T EH0 M IY N Y
petista|P EH0 T IY S T AE
petróleo|P EH0 T R AO L IY UW
petúnia|P EH0 T UW N Y AE
pezinho|P EH Z IY N IY0 UW
peça|P EH S AA
pi|P IY
pia|P IY AA
pianinho|P IY AA N IY N IY0 UW
pianista|P IY AA N IY SH T AA
pib|P IY B IY
picadeiro|P IY K AE D EH0 Y R UW
picadilha|P IY K AE D IY L IY AA
picardia|P IY K AE RH D IY AA
picareta|P IY K AE R EH0 T AA
pichação|P IY SH AE S AA W
piche|P IY SH IY
picho|P IY SH UW
pico|P IY K UW
picolé|P IY K OW0 L EH
piedade|P Y EH0 D AE D ZH IY
piemonte|P IY EH0 M T IY
piemontês|P Y EH0 M T EH0 SH
pierre|P Y EH RH IY
pietista|P IY EH0 T IY S T AA
pietra|P Y EH0 T R AA
pietro|P Y EH0 T R UW
pila|P IY L AA
pilantra|P IY L AA T R AE
pilha|P IY L IY AA
pilhão|P IY L IY AA W
pilo|P IY L UW
piloro|P IY L OW0 R UW
piloto|P IY L AO T UW
pilsen|P IY W S Y
pilão|P IY L AA W
pimenta|P IY M T AA
pimenteiro|P IY M T EH0 Y R UW
pimento|P IY M T UW
pimentão|P IY M T AA W
pimpão|P P AA W
pingo|P G UW
pingolim|P G UW L
pinguim|P G W
pinoia|P IY N AO Y AE
pinote|P IY N AO T IY
pinotes|P IY N AO T IY S
pinque|P K IY
pinta|P T AA
pintada|P T AE D AA
pintar|P T AE RH
pintassilgos|P T AE S IY W G UW S
pinto|P T UW
pipa|P IY P AA
pipe|P AE Y P IY
pipi|P IY P IY
pipoca|P IY P AO K AA
pique|P IY K IY
pira|P IY R AA
pirata|P IY R AE T AA
pires|P IY R IY S
piriguete|P IY R IY G EH T SH IY
pirilampo|P IY R IY L AA P UW
piriri|P IY R IY R IY
pirita|P IY R IY T AA
piroca|P IY R AO K AA
piroxena|P IY R OW0 K IY S EH0 N AA
pirralho|P IY RH AE L IY UW
piru|P IY R UW
pirulito|P IY R UW L IY T UW
pirão|P IY R AA W
pirólise|P IY R AO L IY Z IY
pisa|P IY Z AA
piso|P IY Z UW
pista|P IY S T AA
pitaco|P IY T AE K UW
pitanga|P IY T AA G AA
pito|P IY T UW
pitu|P IY T UW
pitão|P IY T AA W
pitéu|P IY T EH W
pivete|P IY V EH T SH IY
pivô|P IY V OW0
pixulé|P IY SH UW L EH
piza|P IY Z AA
pizza|P IY T SH IY S AA
pizzaiolo|P IY T S AE Y OW0 L UW
piça|P IY S AA
placa|P L AE K AA
placebo|P L AE S EH0 B UW
placenta|P L AE S T AA
plangente|P L AA ZH T IY
planisfério|P L AA N IY S F EH R Y UW
plano|P L AA N UW
planta|P L AA T AA
plantão|P L AA T AA W
plateia|P L AE T EH Y AA
platô|P L AE T OW0
plausível|P L AE W Z IY V EH0 W
player|P L EH0 Y EH0 RH
playground|P L EH0 Y G R AE W D
plebeiamente|P L EH0 B EH Y AA M T IY
pleito|P L EH0 Y T UW
pleno|P L EH0 N UW
pleonástico|P L EH0 OW0 N AE SH T IY K UW
plotador|P L OW0 T AE D OW0 RH
plotadora|P L OW0 T AE D OW0 R AE
plotagem|P L OW0 T AE ZH AA
plutão|P L UW T AA W
plátano|P L AE T AA N UW
plínio|P L IY N Y UW
pneu|P N EH0 W
pneumoconiose|P N EH0 W M UW K OW0 N IY AO Z IY
pneumonia|P N EH0 W M OW0 N IY AA
poaense|P OW0 AE S IY
pobre|P AO B R IY
pobreza|P OW0 B R EH0 Z AA
podcast|P AO D IY K EH S T SH IY
poder|P AO D EH0 HH
poderoso|P OW0 D EH0 R OW0 Z UW
podre|P OW0 D R IY
podrão|P OW0 D R AA W
poeira|P UW EH0 Y R AA
poema|P AO M AA
poesia|P OW0 EH0 Z IY AE
poetisa|P OW0 EH0 T IY Z AA
point|P Y T IY
poio|P OW0 Y UW
polegada|P OW0 L EH0 G AE D AA
poliamor|P AO L IY AA M OW0 R
poliana|P OW0 L IY AA N AA
poliandria|P OW0 L IY AA D R IY AE
poliban|P AO L IY B AA
polichinelo|P OW0 L IY SH IY N EH L UW
policial|P UW L IY S IY AE W
poligamia|P OW0 L IY G AA M IY AE
poliginia|P OW0 L IY ZH IY N IY AE
poligâmico|P OW0 L IY G AA M IY K UW
poliuria|P AO L IY UW R IY AE
polivalente|P OW0 L IY V AE L T SH IY
poliúria|P AO L IY UW R Y AE
polo|P AO L UW
polução|P OW0 L UW S AA W
polvilho|P AO W V IY L IY UW
polvo|P OW0 W V UW
polícia|P OW0 L IY S Y AA
política|P UW L IY T IY K AA
político|P UW L IY T IY K UW
polônio|P OW0 L OW0 N Y UW
pomada|P OW0 M AE D AA
pomba|P B AA
pomerânia|P OW0 M EH0 R AA N IY AA
pompom|P P
pondera|P D EH R AA
pondo|P D UW
ponhar|P N IY0 AE HR
ponta|P T AA
pontapé|P T AE P EH
ponte|P T IY
ponteira|P T EH0 Y R AE
ponteiro|P T EH0 Y R UW
ponto|P T UW
pontualidade|P T W AE L IY D AE D IY
pontuar|P T UW AE RH
pontuação|P T UW AE S AA W
popularizar|P OW0 P UW L AE R IY Z AE RH
população|P OW0 P UW L AE S W
por|P UW RH
porcaria|P OW0 R K AE R IY AA
pormenor|P OW0 RH M EH0 N AO RH
pormenores|P OW0 RH M EH0 N AO R IY S
pornografia|P OW0 RH N OW0 G R AE F IY AA
porongo|P OW0 R G UW
porque|P UW RH K EH0
portinha|P AO HH T N IY0 AA
portona|P AO HH T N AA
portuguesismo|P OW0 RH T UW G EH0 Z IY Z M UW
portão|P AO HH T AA W
positivismo|P OW0 Z IY T IY V IY SH M UW
positivista|P OW0 Z IY T IY V IY SH T AA
positivo|P OW0 Z IY T IY V UW
posição|P OW0 Z IY S AA W
possa|P AO S AA
posse|P AO S IY
posseiro|P OW0 S EH0 Y R UW
possessivo|P OW0 S EH0 S IY V UW
possibilidade|P OW0 S IY B IY L IY D AE D ZH IY
possibilitar|P OW0 S IY B IY L IY T AE RH
posso|P AO S UW
possível|P OW0 S IY V EH0 W
post|P OW0 W S T
postergar|P OW0 S T EH0 RH G AE RH
posterioridade|P OW0 S T EH0 R Y OW0 R IY D AE D IY
posteriormente|P OW0 S T EH0 R Y OW0 RH M T IY
potencialidade|P OW0 T S Y AE L IY D AE D ZH IY
potra|P OW0 T R AA
potro|P OW0 T R UW
potência|P OW0 T S Y AA
pouca|P OW0 W K AA
pouco|P OW0 W K UW
poupa|P OW0 W P AA
poupança|P OW0 W P AA S AA
pouquíssimo|P OW0 W K IY S IY M UW
pousada|P OW0 W Z AE D AA
povo|P OW0 V UW
povos|P AO V UW S
powerpoint|P AE W EH0 RH P AO Y T
poça|P AO S AA
poço|P OW0 S UW
pra|P R AE
praia|P R AE Y AA
prancha|P R AA SH AA
pranto|P R AA T UW
pras|P R AE S
praseodímio|P R AE Z Y UW D IY M Y UW
prata|P R AE T AA
prataria|P R AE T AE R IY AA
praticabilidade|P RRR AE T SH IY K AE B IY L IY D AE D ZH IY
praticar|P R AE T SH IY K AE RH
prato|P R AE T UW
prazer|P R AE Z EH0 RH
prazo|P R AE Z UW
prece|P R EH S IY
precedente|P R EH0 S EH0 D T IY
precoce|P R EH0 K AO S IY
preconceito|P R EH K S EH0 Y T UW
preeminência|P RRR EH0 EH0 M IY N S Y AE
preencher|P R EH0 SH EH0 RH
preferido|P RRR EH0 F EH0 R IY D UW
preferir|P R EH0 F EH0 R IY RH
prefixo|P R EH0 F IY K S UW
prega|P R EH G AA
pregador|P R EH G AE D OW0
preguicite|P R EH0 G IY S IY T IY
preju|P R EH0 ZH UW
prejudicar|P R EH0 ZH UW D ZH IY K AE RH
prejuízo|P R EH0 ZH W IY Z UW
prelado|P R EH0 L AE D UW
prelibar|P R EH0 L IY B AE RH
prelibava|P R EH0 L IY B AE V AA
premente|P R EH0 M T SH IY
premiar|P R IY M IY AE RH
premiu|P R EH0 M IY W
prensa|P R S AA
preocupar|P R EH0 W K UW P AE RH
preocupação|P R EH0 W K UW P AE S AA W
preparado|P R EH0 P AE R AE D UW
preparar|P R EH0 P AE R AE RH
preparação|P R EH0 P AE R AA S AA W
preplexa|P EH0 RH P L EH K S AA
preponderância|P R EH P D EH0 RRR S Y AE
preposição|P R EH0 P OW0 Z IY S AA W
prepotência|P R EH P OW0 T S Y AE
prerrogativa|P R EH0 RH OW0 G AA T IY V AA
presa|P R EH0 Z AA
prescritível|P R EH0 S K RRR IY T SH IY V EH0 W
presente|P R EH0 Z T IY
presentear|P R EH0 Z T IY AE RH
presença|P R EH0 Z S AA
presepada|P R EH0 Z EH0 P AE D AE
preservar|P R EH0 Z EH0 RH V AE RH
preservação|P R EH0 Z EH0 RH V AE S AA W
presidiário|P R EH0 Z IY D IY AE R IY UW
presilha|P R IY Z IY L IY AA
pressa|P R EH S AA
pressentimento|P R EH0 S T IY M T UW
pressão|P R EH0 S AA W
prestar|P R EH0 S T AE RH
presumir|P R EH0 Z UW M IY RH
presunto|P R EH0 Z T UW
presunçoso|P R EH0 Z S OW0 Z UW
presépio|P R EH0 Z EH P Y UW
preta|P R EH0 T AA
pretender|P R EH0 T D EH0 RH
pretinho|P R EH0 T IY Y UH
preto|P R EH0 T UW
prevaricador|P R EH0 V AE R IY K AE D OW0 RH
prevenir|P R EH0 V EH0 N IY RH
prevenção|P R EH0 V S AA W
prever|P R EH0 V EH0 RH
previsto|P R EH0 V IY SH T UW
previsão|P R EH0 V IY Z AA W
preço|P R EH0 S UW
primata|P R IY M AE T AA
primário|P R IY M AE R Y UW
princesa|P R S EH0 Z AA
principiar|P R S IY P IY AE RH
principiou|P R S IY P IY OW0 W
princípio|P R S IY P Y UW
princípios|P R S IY P Y UW S
print|P R T SH IY
prisioneiro|P R IY Z Y OW0 N EH0 Y R UW
prisão|P R IY Z AA W
privatizar|P R IY V AE T IY Z AE RH
privilégio|P R IY V IY L EH ZH Y UW
pro|P R UW
proa|P RRR OW0 AA
probidade|P R OW0 B IY D AE D IY
proceder|P R OW0 S EH0 D EH0 RH
procedimento|P R OW0 S EH0 D IY M T UW
procedência|P R OW0 S EH0 D S IY AA
processar|P R OW0 S EH0 S AE RH
processo|P R OW0 S EH S UW
procissão|P R OW0 S IY S AA W
procura|P R UW K UW R AA
procurando|P R OW0 K UW R AA D UW
procurar|P R UW K UW R AE R
procuro|P R OW0 K UW R UW
produz|P R OW0 D UW Y SH
produzir|P R OW0 D UW Z IY RH
produção|P R OW0 D UW S AA W
proeminência|P RRR OW0 EH0 M IY N S Y AE
profano|P R OW0 F AA N UW
profecia|P R OW0 F EH0 S IY AA
proferida|P R OW0 F EH0 R IY D AA
profissional|P R OW0 F IY S Y OW0 N AE W
profunda|P R OW0 F D AA
profundo|P R OW0 F D UW
profícuo|P R OW0 F IY K W UW
programa|P R OW0 G R AA M AA
programador|P R OW0 G R AA M AE D OW0 RH
programação|P R OW0 G R AE M AE S AA W
progressiva|P R OW0 G R EH0 S IY V AA
progresso|P R AO G R EH S UW
proibição|P R OW0 Y B IY S AA W
projete|P R OW0 ZH EH T SH IY
promete|P R OW0 M EH T SH IY
prometer|P R OW0 M EH0 T EH0 RH
promontório|P R OW0 M T AO R Y UW
promover|P R OW0 M OW0 V EH0 RH
promécio|P R OW0 M EH S Y UW
pronto|P R T UW
prontuário|P R T UW AE R IY UW
pronuncia|P R UW N S IY AA
pronunciar|P R UW N S Y AE R
pronúncia|P R UW N S Y AA
propor|P R OW0 P OW0 RH
proporcionar|P R OW0 P OW0 RH S Y OW0 N AE RH
proporção|P R OW0 P OW0 RH S AA W
proposição|P R OW0 P OW0 Z IY S AA W
proposta|P R OW0 P AO S T AA
propriedade|P R AO P R Y EH D AE D IH
proprietário|P R OW0 P R Y EH0 T AE R Y UW
propósito|P R OW0 P AO Z IY T UW
pros|P R UW S
prosa|P R AO Z AA
prosaico|P R OW0 Z AE Y K UW
prosseguir|P R OW0 S EH0 G IY RH
prostituta|P R AO SH T IY T UW T AA
prostitutas|P R OW0 S T IY T UW T AA S
prostrar|P R OW0 S T R AE R
protactínio|P R OW0 T AE K T IY N Y UW
proteger|P R OW0 T EH0 ZH EH0 RH
protelar|P R OW0 T EH0 L AE HR
proteína|P R OW0 T EH0 IY N AA
protista|P R OW0 T IY S T AA
protuberância|P R OW0 T UW B EH0 R AA S Y AA
protótipo|P R OW0 T AO T IY P UW
prova|P R AO V AA
prover|P R OW0 V EH0 RH
providenciar|P R OW0 V IY D S IY AE RH
provincial|P R OW0 V S IY AE W
provir|P R OW0 V IY RH
provisão|P R OW0 V IY Z AA W
provocadora|P R OW0 V OW0 K AE D OW0 R AA
provocar|P R OW0 V OW0 K AE
provável|P R OW0 V AE V EH0 W
província|P R OW0 V S Y AA
proxy|P R AO K S IY
prum|P R
pruma|P R UW M AA
prumas|P R UW M AA S
pruns|P R S
prácrito|P R AE K R IY T UW
prático|P R AE T IY K UW
prêmio|P R EH0 M Y UW
pró|P R AO
próclise|P R AO K L IY Z IY
próxima|P R AO S IY M AA
próximo|P R AO S IY M UW
prússia|P R UW S Y AE
pseudociência|P S EH0 W D OW0 S IY S IY AA
pseudônimo|P S EH0 W D OW0 N IY M UW
psicanálise|P S IY K AA N AE L IY Z IY
psicologia|P IY S IY K OW0 L OW0 ZH IY AA
psicológica|P S IY K OW0 L AO ZH IY K AA
psicológico|P S IY K OW0 L AO ZH IY K UW
psicopata|P S IY K OW0 P AE T AA
psicóloga|P S IY K AO L OW0 G AE
psicólogo|P S IY K AO L OW0 G UW
psiquiatra|P S IY K Y AE T R AA
psiquiatria|P S IY K IY AE T R IY AE
psiquê|P S IY K EH0
psíquica|P S IY K IY K AA
psíquico|P S IY K IY K UW
publicano|P UW B L IY K AA N UW
publicar|P UW B L IY K AE RH
publicidade|P UW B L IY S IY D AE D IY
publicitado|P UW B L IY S IY T AE D UW
pugnar|P UW G IY N AE RH
pulava|P UW L AE V AA
pulcro|P UW L K RRR UH
pulquérrimo|P UW W K EH RH IY M UW
puma|P UW M AA
punheta|P UW N IY0 EH0 T AA
punhete|P UW N IY0 EH T SH IY
punk|P AA K
pupila|P UW P IY L AA
pureza|P UW R EH0 Z AA
purga|P UW RH G AA
purificar|P UW R IY F IY K AE R
puritano|P UW R IY T AA N UW
puro|P UW R UW
purulento|P UW R UW L T UW
puré|P UW R EH
pusera|P UW Z EH R AA
puseram|P UW Z EH R AA W
pusilanimidade|P UW Z IY L N IY M IY D AE D ZH IY
pusilânime|P UW Z IY L AA N IY M IY
puto|P UW T UW
putz|P UW T S
puxa|P UW SH AA
puxar|P UW SH AE RH
pá|P AE
página|P AE ZH IY N AA
páli|P AE L IY
pártia|P AE RH T IY AA
pátio|P AE T Y UW
pátria|P AE T R Y AA
pânico|P AA N IY K UW
pântano|P AA T AE N UW
pã|P AA
pão|P AA W
pé|P EH
pérgamo|P EH RH G AA M UW
pérola|P EH R AO L AE
pê|P EH0
pêssanka|P EH0 S AA K AA
pílula|P IY L UW L AA
pó|P AO
pólux|P AO L UW K S
pô|P OW0
põe|P Y
púbis|P UW B IY S
público|P UW B L IY K UW
púcaro|P UW K AE R UW
púnhamos|P UW N IY0 AA M UW S
pústula|P UW S T UW L AA
q|K EH0
quadrado|K W AE D R AE D UW
quadragésimo|K W AE D R AE ZH EH Z IY M UW
quadro|K W AE D R UW
qualidade|K W AE L IY D AE D IY
qualificar|K W AE L IY F IY K AE RH
quando|K W AA D UW
quanta|K W AA T AA
quantia|K W AA T IY AA
quantidade|K W AA T IY D AE D IY
quantitativa|K W AA T IY T AE T IY V AA
quantitativas|K W AA T IY T AE T IY V AA S
quantitativo|K W AA T IY T AE T IY V UW
quantitativos|K W AA T IY T AE T IY V UW S
quanto|K W AA T UW
quantum|K W AA T
quaresma|K W AE R EH ZH M AA
quartinho|K W AE HH T N IY0 UW
quartzo|K W AE HH T S UW
quatro|K W AE T R UW
quebra|K EH B R AA
quebracho|K EH0 B R AE SH UW
quebradeira|K EH0 B R AE D EH0 Y R AA
quebrantamento|K EH0 B R AA T AE M T UW
quebrar|K EH0 B R AE RH
queca|K EH K AA
queda|K EH D AA
queimadura|K M AE D UW R AA
queixa|K EH0 Y SH AA
queixada|K EH0 IY SH AE D AE
queixar|K EH0 Y SH AE RH
quelimane|K EH0 L IY M AE N IY
quelónio|K EH0 L OW0 N Y UW
quem|K Y
quera|K W EH R AE
querer|K EH R EH0 HH
quero|K EH R UW
questionar|K W EH0 S T SH OW0 N AE RH
questão|K W EH0 S T AA W
quiabeiro|K IY AE B EH0 Y R UW
quieto|K EH T UW
quilha|K IY L IY AA
quilo|K IY L UW
quilowatt|K IY L OW0 V AE T
quimera|K IY M EH R AA
quimérico|K IY M EH R IY K UW
quinhão|K IY N IY0 AA W
quinquagésimo|K K W AE ZH EH Z IY M UW
quinta|K T AA
quintino|K T IY N UW
quinto|K T UW
quiosque|K IY AO S K IY
quiprocó|K IY P R OW0 K AO
quiproquó|K W IY P R OW0 K W AO
quipá|K IY P AE
quisera|K IY Z EH R AA
quiseram|K IY Z EH R AA W
quisto|K IY S T UW
quitanda|K IY T D AE
quite|K IY T IY
quivi|K IY V IY
quizumba|K IY Z B AE
quiçá|K IY S AE
quota|K W AO T AA
quão|K W AA W
quê|K EH0
quíchua|K IY SH UW AA
química|K IY M IY K AE
químico|K IY M IY K UW
quíton|K IY T
quórum|K W AO R
qüiproquó|K W IY P R OW0 K W AO
rabicho|RH AE B IY SH UW
rabino|RH AE B IY N UW
rabo|RH AE B UW
rabugento|RH AE B UW ZH T UW
racial|RH AE S Y AE W
racional|RH AE S IY OW0 N AE W
racionalizada|RH AE S Y OW0 N AE L IY Z AE D AA
radicar|RH AE D IY K AE RH
raimundo|RH AE Y M D UW
raivoso|RH AE Y V OW0 Z UW
rajastão|RH AE ZH AE S T AA W
ralé|RH AE L EH
rama|RH AA M AA
ramiro|RH AE M IY R UW
rampa|RH AA P AA
rancor|RH AA K OW0 RH
rangir|RH AA ZH IY R
rangum|RH AA G
ranqueada|RH AA K Y AE D AA
ranqueado|RH AA K Y AE D UW
rap|RH EH P IY
rapé|RH AE P EH
rasgo|RH AE Z G UW
rastro|RH AE S T R UW
rasuro|RH AE Z UW R UW
rateadora|RH AE T Y AE D OW0 R AA
ratinho|RH AE T IY N IY0 UW
ratoeira|RH AE T UW EH0 Y R AA
ravina|RH AE V IY N AA
raça|RH AE S AA
reagir|HR EH0 AA ZH IY HR
reais|RH EH0 AE Y S
realidade|RH EH0 AE L IY D AE D IY
realizar|RH EH0 AE L IY Z AE RH
reação|RH EH0 AE S AA W
rebanho|RH EH0 B AA N IY0 UW
rebelde|RH EH0 B EH W D IY
rebite|RH IY B IY T IY
rebobinar|RH EH0 B OW0 B IY N AE RH
recado|RH EH0 K AE D UW
recalculação|RH EH0 K AE W K UW L AE S AA W
recato|RH IY K AE T UW
receber|RH EH0 S EH0 B EH0 RH
recebo|RH EH0 S EH0 B UW
recentíssima|RH EH0 S T IY S IY M AA
recentíssimo|RH EH0 S T IY S IY M UW
recibo|RH EH0 S IY B UW
recinto|RH EH0 S N T UW
recipiente|RH EH0 S IY P IY T IY
reclamar|RH EH0 K L AA M AE RH
reclinar|RH EH0 K L IY N AE RH
reclinou|RH EH0 K L IY N OW0 W
reco|RH EH K UW
recolha|RH EH0 K OW0 L IY AA
recombinação|RH IY K B IY N AE S AA W
recomendar|RH EH0 K OW0 M D AE RH
recompensa|RH EH0 K P S AA
recompense|RH EH0 K P S IY
reconciliar|RH EH0 K S IY L Y AE R
reconhecer|RH EH0 K OW0 N IY0 EH0 S EH0 RH
reconhecimento|RH EH0 K UW N IY0 EH0 S IY M T UW
reconquista|RH EH0 K K IY S T AA
recordista|RH EH0 K OW0 RH D IY S T AA
recostada|RH EH0 K OW0 S T AE D AA
recostado|RH EH0 K OW0 S T AE D UW
recostar|RH EH0 K OW0 S T AE RH
recostou|RH EH0 K OW0 S T OW0 W
recuperar|RH EH0 K UW P EH0 R AE RH
recusar|RH EH0 K UW Z AE RH
recíproco|RH EH0 S IY P R OW0 K UW
redonda|RH EH0 D D AA
redundância|RH EH0 D D AA S IY AA
reduz|RH EH0 D UW Y S
redução|RH EH0 D UW S AA W
redário|RH EH0 D AE R Y UW
referir|RH EH0 F IY R IY R
referência|RH EH0 F EH0 R Y S Y AA
refizesse|RH EH0 F IY Z EH0 S IY
reflexo|RH EH0 F L EH K S UW
reforma|RH EH0 F AO RH M AA
reformista|RH EH0 F AO RH M IY S T AA
refri|RH EH0 F R IY
refrigerante|RH EH0 F R IY ZH EH0 R AA T IY
refugiado|RH EH0 F UW ZH IY AE D UW
regalar|RH EH0 G AE L AE RH
regalo|RH IY G AE L UW
regata|RH EH0 G AE T AE
regatinho|RH EH0 G AE T IY N IY0 UW
regatinhos|RH EH0 G AE T IY N IY0 UW S
regato|RH EH0 G AE T UW
reggae|RH EH G IY
regime|RH IY ZH IY M IY
regimento|RH EH0 ZH IY M T UW
regional|RH EH0 ZH Y OW0 N AE W
região|RH EH0 ZH IY AA W
regra|RH EH G R AA
regrar|RH EH0 G R AE RH
regressar|HH EH0 G R EH0 S AE HH
regular|RH EH0 G UW L AE RH
regímen|RH EH0 ZH IY M Y
reich|RH AE Y SH
reivindicação|RH EH0 Y V D ZH IY K AE S AA W
rejeitar|RH EH0 ZH EH0 Y T AE RH
rejogar|RH EH0 ZH OW0 G AE R
relacionado|RH EH0 L AE S Y OW0 N AE D UW
relacionamento|RH EH0 L AE S Y OW0 N AE M T UW
relatar|RH EH0 L AE T AE RH
relativamente|RH EH0 L AE T IY V AA M T IY
relativismo|RH EH0 L AE T IY V IY SH M UW
relativo|RH EH0 L AE T SH IY V UW
relato|RH EH0 L AE T UW
relatório|RH EH0 L AE T AO R Y UW
relaxar|RH EH0 L AE SH AE RH
relação|RH EH0 L AE S AA W
relevante|RH EH0 L EH0 V AA T SH IY
religiosamente|RH EH0 L IY IY ZH IY AO Z AE M Y T SH IY
religioso|RH EH0 L IY ZH IY OW0 Z UW
religião|RH EH0 L IY ZH IY AA W
relógio|RH EH0 L AO ZH Y UW
remanejamento|RH EH0 M AE N EH0 ZH AE M T UW
remanejar|RH EH0 M AE N EH0 ZH AE R
remanescente|RH EH0 M AA N EH0 S T IY
remela|RH EH0 M EH L AA
remendo|RH EH0 M D UW
remete|RH EH0 M EH T SH IY
remexer|RH EH0 M EH0 SH EH0 RH
remexida|RH EH0 M EH0 SH IY D AA
remo|RH EH0 M UW
remodelar|RH EH0 M OW0 D EH0 L AE RH
remover|RH EH0 M OW0 V EH0 RH
remédio|RH EH0 M EH D Y UW
renan|RH EH0 N AA
renano|RH EH0 N AA N UW
renascente|RH EH0 N AE S T IY
renascentista|RH EH0 N AE S T IY S T AA
renascença|RH EH0 N AE S S AA
renata|RH EH0 N AE T AA
renato|RH EH0 N AE T UW
renderizar|RH D EH0 R IY Z AE RH
rendição|RH D IY S AA W
renque|RH K IY
renânia|RH EH0 N AA N IY AA
renúncia|RH EH0 N S Y AA
reparo|RH EH0 P AE R UW
repetir|RH EH0 P IY T IY R
replantais|RH EH0 P L AA T AE Y S
replica|RH EH0 P L IY K AA
reportagem|RH EH0 P OW0 RH T AE ZH Y
reportar|RH EH0 P OW0 RH T AE RH
repouso|RH EH0 P OW0 W Z UW
repreensão|HH EH0 P R EH0 S AA UH
represa|RH EH0 P R EH Z AA
representar|RH EH0 P R EH0 Z T AE RH
representativo|RH EH0 P R EH0 Z T AE T IY V UW
reprise|RRR EH0 P RRR IY Z IY
repugnância|RH EH0 P UW G N AA S Y AA
repuxada|RH EH0 P UW SH AE D AA
república|RH IY P UW B L IY K AA
requerer|RH EH0 K EH0 R EH0 RH
requinte|RH EH0 K T IY
requisito|RH EH0 K IY Z IY T UW
rescaldar|RH EH S K AE W D AE RH
resenha|RH EH0 Z EH0 N IY0 AA
reserva|RH IY Z EH RH V AA
reset|RH EH0 Z EH T SH IY
resetar|RRR EH0 Z EH0 T AE HR
resete|RH EH0 Z EH T SH IY
resfriado|RH EH0 SH F R IY AE D UW
residente|RH EH0 Z IY D T IY
residência|RH EH0 Z IY D S Y AA
resignar|RH EH0 Z IY G IY N AE RH
resiliente|RH EH0 Z IY L Y T IY
resina|RH EH0 Z IY N AA
resistir|RH EH0 Z IY SH T IY HR
resolver|RH EH0 Z OW0 W V EH0 RH
respeitadora|RH EH0 S P EH0 Y T AE D OW0 R AA
respirar|RH EH0 S P IY R AE R
respiração|RH EH0 S P IY R AE S AA W
responder|RH EH0 S P D EH0 RH
responsável|RH EH0 S P S AE V EH0 W
resposta|RH EH0 S P AO S T AA
ressarcimento|RH EH0 S S AE R S IY M T UW
ressentimento|RH EH0 S T IY M T UW
ressignificar|RH EH0 S IY G N IY F IY K AE R
restar|RH EH0 S T AE RH
restaurante|RH EH0 S T AE W R AA T IY
restaurar|RH EH0 S T AE W R AE RH
resto|RH EH S T UW
restringir|RH EH0 S T R ZH IY RH
resultado|RH EH0 Z UW W T AE D UW
resultante|RH EH0 Z UW W T AA T IY
resultar|RH EH0 Z UW W T AE RH
retalho|RH IY T AE L IY UW
reter|RH EH0 T EH0 RH
retirar|RH EH0 T IY R AE RH
retornar|RH EH0 T OW0 RH N AE RH
retorno|RH EH0 T OW0 RH N UW
retrasado|RH EH0 T R AE Z AE D UW
retrógrado|RH IY T R AO G R AE D UW
reunião|HH EH0 UW N Y AA W
reutilizar|RH EH0 W T SH IY L IY IY Z AE R
revanchismo|RH EH0 V AA SH IY Z M UW
revelar|RH EH0 V EH0 L AE RH
revelação|RH EH0 V EH0 L AE S AA W
revezar|RH EH0 V EH0 Z AE HR
revisar|RH EH0 V IY Z AE RH
revista|RH EH0 V IY S T AA
revisão|RH IY V IY Z AA W
revolução|RH EH0 V OW0 L UW S AA W
revés|RH IY V EH S
rezar|RH EH0 Z AE RH
rezende|RH EH0 Z D ZH IY
ria|RH IY AA
rias|RH IY AA S
ribeiro|RH IY B EH0 Y R UW
ricardo|HR IY K AE HR D UW
rifa|RH IY F AA
rifle|RH IY F L IY
rime|RH IY M IY
ripostou|RH IY P OW0 S T OW0 W
riqueza|RH IY K EH0 Z AA
risco|RH IY S K UW
ritmo|HH IY T SH M UW
rito|RH IY T UW
ritual|RH IY T W AE L
riável|R IY AE V EH0 W
robalo|RH OW0 B AE L UW
roca|RH AO K AA
rocha|RH AO SH AA
rochoso|RH OW0 SH OW0 Z UW
rock|RH AO K IY
roda|RH AO D AA
rodeado|RH OW0 D IY AE D UW
rodo|RH AO D UW
rodolfo|RH OW0 D OW0 W F UW
rodovia|RH OW0 D OW0 V IY AA
rodoviário|RH OW0 D OW0 V IY AE R Y UW
rodrigues|RH OW0 D R IY G IY SH
rogério|RH OW0 ZH EH R Y UW
rojão|RH OW0 ZH AA W
rola|RH AO L AE
rolando|RH OW0 L AA D UW
roldão|RH OW0 W D AA W
rolha|RH OW0 L IY AA
rolinho|RH OW0 L IY N IY0 UW
rom|RH AO M
romaji|RH OW0 M AE ZH IY
romana|RH OW0 M AA N AA
romance|RH OW0 M AA S IY
romanche|RH OW0 M AA SH IY
romano|RH OW0 M AA N UW
romantismo|RH OW0 M AA T IY Z M UW
romeno|RH OW0 M EH0 N UW
romeu|RH OW0 M EH0 W
romão|RH OW0 M AA W
romãzeira|RH OW0 M AA Z EH0 Y R AA
ronco|RH K UW
ronda|RH D AA
ronrom|RH RH
ronrono|RH RH OW0 N UW
ronrons|RH RH S
root|RH UW T
roqueiro|RH OW0 K EH0 Y R UW
rosca|HH OW0 S K AA
rosela|RH OW0 Z EH L AA
rostov|RH OW0 S T AO V
rottweiler|RH AO T V AE Y L EH0 RH
roubalheira|RH OW0 W B AE L IY EH0 Y R AA
rouco|RH OW0 W K UW
round|RRR AE W D
roupeiro|RH OW0 W P EH0 Y R UW
rouquidão|RH OW0 W K IY D AA W
rovaniemi|RH OW0 V AE N IY EH0 M IY
roça|RH AO S AA
roídos|RH OW0 IY D UW S
rubens|RH UW B Y S
rubi|HH UW B IY
rubéola|RH UW B EH W L AA
rude|RH UW D ZH IY
rugas|RH UW G AA SH
rugby|RH AA G B IY
rugir|RH UW ZH IY R
rugosa|RH UW G AO Z AA
ruim|RH Y
ruins|RH Y S
rumar|RH UW M AE R
rumo|RH UW M UW
rumorosa|RH UW M OW0 R AO Z AA
rutilo|RH UW T IY L AA
rutilância|RH UW T SH IY L S Y AE
rutênia|RH UW T EH0 N IY AA
rápido|RH AE P IY D UW
récord|RH EH K OW0 RH D IY
réplica|RH EH P L IY K AA
réptil|HH EH P T IY W
réveillon|RH EH0 V EH0 Y W
rígido|RH IY ZH IY D UW
rítmico|HH IY T SH M IY K UW
rótula|RH AO T UW L AA
rúgbi|R UW G B IY
saara|S AE AE R AA
sabonete|S AE B OW0 N EH0 T SH IY
sabor|S AE B OW0 RH
sabão|S AE B AA W
saca|S AE K AA
sacada|S AE K AE D AA
sacarose|S AE K AA R AO Z IY
sacerdote|S AE S EH0 RH D AO T IY
sacho|S AE SH UW
sachola|S AE SH AO L AA
saco|S AE K UW
sacola|S AE K AO L AA
sacolé|S AE K OW0 L EH
sacra|S AE K R AA
sacrifício|S AE K R IY F IY S Y UW
sacro|S AE K R UW
safa|S AE F AA
safadeza|S AE F AE D EH0 Z AA
safar|S AE F AE RH
safista|S AE F IY SH T AA
sagitário|S AE ZH IY T AE R Y UW
saguão|S AE G W AA W
sai|S AE Y
saia|S AE Y AA
saio|S AE Y UW
saiote|S AE Y AO T SH IY
sala|S AE L AA
salamaleque|S AE L AE M AE L EH0 K IY
salisburgo|S AE L IY Z B UW RH G UW
saliva|S AE L IY V AE
salubérrimo|S AE L UW B EH RH IY M UW
salário|S AE L AE R Y UW
salão|S AE L AA W
samaria|S AE M AE R IY AA
samba|S AA B AA
sambo|S AA B UW
sambódromo|S AA B AO D R OW0 M UW
samo|S AE M UW
samoano|S AE M UW AA N UW
samurai|S AA M UW R AE Y
sandra|S AA D R AA
sandália|S AA D AE L IY AA
saneamento|S AA N IY AA M T UW
sanfona|S AA F OW0 N AA
sangramento|S AA G R AA M T UW
sangrenta|S AA G R T AA
sangrento|S AA G R T UW
sangria|S AA G R IY AA
sangue|S AA G IY
sanguenta|S AA G W T AA
sanguento|S AA G W T UW
sansão|S AA S AA W
santa|S AA T AA
santo|S AA T UW
santos|S AA T UW SH
santuário|S AA T UW AE R Y UW
sanção|S AA S AA W
sapata|S AE P AE T AA
sapateado|S AE P AE T Y AE D UW
sapato|S AE P AE T UW
sapiente|S AE P IY T IY
sapo|S AE P UW
sapão|S AE P AA W
sarado|S AE R AE D UW
sarapatel|S AE R AE P AE T EH W
sarcástico|S AE RRR K AE S T SH IY K UH
sargento|S AE RH ZH T UW
sarilho|S AE R IY L IY UW
sarin|S AE R
sashimi|S AE SH IY M IY
satanás|S AE T AE N AE Y S
satiríase|S AE T IY R IY AE Z IY
satisfazer|S AE T SH IY S F AE Z EH0 RH
satisfação|S AE T SH IY SH F AE S AA W
satélite|S AE T EH L IY T SH IY
saudação|S AE W D AE S AA W
sauna|S AE W N AA
saxofone|S AE K S OW0 F OW0 N IY
saxão|S AE K S AA W
scrapie|S K R EH0 Y P IY
sebastianismo|S EH0 B AE S T Y AA N IY Z M UW
sebe|S EH B IY
sebo|S EH0 B UW
seca|S EH K AA
seco|S EH K UW
secrete|S EH0 K R EH T SH IY
secretária|S EH0 K R EH0 T AE R Y AA
secretário|S EH0 K R EH0 T AE R Y UW
seda|S EH0 D AA
sedição|S EH0 D IY S AA W
segar|S EH0 G AE RH
segmento|S EH0 G IY M T UW
segredar|S EH0 G R EH0 D AE RH
segredo|S EH0 G R EH0 D UW
segregação|S EH0 G R IY G AE S AA W
segue|S EH G IY
seguidor|S EH0 G IY D OW0 RH
seguindo|S EH0 G D UW
seguinte|S IY G T IY
seguir|S EH0 G IY RH
seguradora|S EH0 G UW R AE D OW0 R AA
segurança|S IY G UW R AA S AA
segurar|S EH0 G UW R AE RH
seguridade|S EH0 G UW R IY D AE D IY
seira|S EH0 Y R AA
seje|S EH0 ZH IY
sela|S EH L AA
selene|S EH0 L EH0 N IY
selenita|S EH0 L EH0 N IY T AA
selenologia|S EH0 L EH0 N OW0 L OW0 ZH IY AA
selma|S EH W M AA
selo|S EH L UW
selva|S EH W V AA
selvagem|S EH0 W V AE ZH Y
semeador|S EH0 M EH0 AE D OW0 RH
semeadura|S EH0 M IY AE D UW R AA
semente|S EH0 M T IY
sementeira|S EH0 M T EH0 Y RRR AE
semestre|S EH0 M EH SH T R IY
semiólogo|S EH0 M Y AO L OW0 G UW
semáforos|S EH0 M AE F OW0 R UW S
senciente|S S IY T IY
sendo|S D UW
senectude|S IY N EH0 K IY T UW D IY
senhorio|S EH0 N IY0 OW0 R IY W
senhorita|S EH0 N IY0 OW0 R IY T AA
seno|S EH0 N UW
sensatez|S S AE T EH0 Y S
sensato|S S AE T UW
sensação|S S AE S AA W
sensações|S S AE S Y S
sensibilidade|S S IY B IY L IY D AE D IH
senso|S S UW
senta|S T AA
sentar|S T AE RH
sentenciarei|S T S Y AE R EH0 Y
sentença|S T S AA
sentido|S T IY D UW
sentimento|S T IY M T UW
sentinela|S T IY N EH L AA
sentir|S T IY RH
sento|S T UW
separar|S EH0 P AE R AE RH
separarão|S EH0 P AE R AE R AA W
septicemia|S EH0 P T IY S EH0 M IY AA
septicêmico|S EH0 P T IY S EH0 M IY K UW
sepultar|S EH0 P UW W T AE RH
sepultura|S EH0 P UW W T UW R AA
sequestro|S EH K W EH SH T R UH
sequência|S EH0 K W S Y AA
sereno|S EH0 R N UW
serguei|S EH0 RH G EH0 Y
seriado|S EH0 R IY AE D UW
seriar|S EH0 R Y AE RH
seriação|S EH0 R IY AE S AA W
serifa|S EH0 R IY F AA
servi|S EH0 HR V IY
servidor|S EH0 R V IY D OW0 RH
servir|S EH0 RH V IY RH
serviço|S EH0 RH V IY S UW
sesta|S EH SH T AA
set|S EH T SH IY
setembro|S EH T B R UW
setim|S EH0 T SH
seu|S EH0 W
severo|S EH0 V EH R UW
sexo|S EH K S UW
sexy|S EH K S IY
shiitake|SH IY T AE K IY
shiva|SH IY V AA
shizuko|SH IY Z UW K UW
shopping|SH AO P Y
short|SH AO HH T IY
show|SH OW0 W
si|S IY
sicofanta|S IY K OW0 F AA T AA
sidra|S IY D R AA
sigilo|S IY ZH IY L UW
sigla|S IY G L AA
significativo|S IY G N IY F IY K AE T IY V UW
silhueta|S IY L IY W EH0 T AA
silva|S IY W V AA
silvestre|S IY W V EH S T R IY
silêncio|S IY L S Y UW
sim|S
simbologia|S B OW0 L OW0 ZH IY AE
simbólico|S B AO L IY K UW
similar|S IY M IY L AE RH
simonia|S IY M OW0 N IY AA
simpatizante|S P AE T IY Z AA T IY
simples|S P L IY S
simplesmente|S P L IY ZH M T IY
simpático|S P AE T IY K UW
simulacro|S IY M UW L AE K R UW
simum|S IY M
simão|S IY M AA W
simétrico|S IY M EH T R IY K UW
sinalizar|S IY N AE L IY Z AE RH
sinceramente|S S EH R AA M T IY
sindicato|S D IY K AE T UW
sinfonia|S F OW0 N IY AA
single|S G OW0 W
sinquisita|S K IY Z IY T AA
sintaxe|S T AE S IY
sinto|S T UW
sintoma|S T OW0 M AA
sinó|S IY N AO
sipaio|S IY P AE Y UW
siracusa|S IY R AE K UW Z AA
sirene|S IY R EH0 N IY
siribeira|S IY R IY B EH0 Y R AA
siririca|S IY R IY R IY K AE
siso|S IY Z UW
sistema|S IY S T EH0 M AA
sistematizado|S IY S T EH0 M AE T IY Z AE D UW
sitar|S IY T AE RH
situar|S IY T UW AE RH
situação|S IY T UW AE S AA W
skate|S K EH0 Y T
skinhead|S K HH EH D
slide|Z L AE Y D
smartphone|S M AE RH T F OW0 W N
snowboard|IY Z N OW0 W B AO R D IY
sob|S OW0 B IY
sobejar|S OW0 B EH0 ZH AE RH
sobejo|S OW0 B EH0 ZH UW
soberania|S OW0 B EH0 R AA N IY AA
soborô|S OW0 B OW0 R OW0
sobra|S AO B R AA
sobrar|S OW0 B R AE RH
sobre|S AO B R IY
sobreiro|S OW0 B R EH0 Y R UW
sobrenome|S OW0 B R EH0 N OW0 M IY
sobreviver|S OW0 B R EH0 V IY V EH0 RH
sobrinha|S OW0 B R IY N IY0 AA
sobrinho|S OW0 B R IY N IY0 UW
sociabilidade|S OW0 S Y AE B IY L IY D AE D ZH IY
socialismo|S OW0 S Y AE L IY ZH M UW
socialista|S OW0 S Y AE L IY SH T AA
sociedade|S OW0 S Y EH0 D AE D IY
sociniano|S OW0 S IY N Y AA N UW
sociologia|S OW0 S Y OW0 L OW0 ZH IY AA
soclo|S AO K L UW
soer|S OW0 EH0 RH
sofrer|S OW0 F R EH0 RH
sofrimento|S OW0 F R IY M T UW
software|S AO F T IY W EH RH
soja|S AO ZH AA
soldado|S OW0 W D AE D UW
soldo|S AO W D UW
soleira|S OW0 L EH0 Y R AA
solidariedade|S OW0 L IY D AE R Y EH0 D AE D IY
solidão|S OW0 L IY D AA W
sologamia|S AO L OW0 G AA M IY AE
soltar|S OW0 W T AE RH
solteiro|S OW0 W T EH0 Y R UW
solucionar|S OW0 L UW S Y OW0 N AE RH
soluço|S OW0 L UW S UW
solução|S OW0 L UW S AA W
solão|S AO L AA W
som|S
somali|S OW0 M AE L IY
sombra|S B R AA
sombrio|S B R IY W
some|S AO M IY
sonda|S D AA
soneto|S UW N EH0 T UW
sonha|S N IY0 AA
sonhar|S OW0 N IY0 AE RH
sonho|S OW0 N IY0 UW
sonoplastia|S OW0 N OW0 P L AE SH T IY AE
sonso|S S UW
sonzeira|S Z EH0 Y R AA
soo|S OW0 UW
sopa|S OW0 P AA
sopesar|S OW0 P EH0 Z AE RH
soprar|S OW0 P R AE RH
sopro|S AO P R UW
sopé|S OW0 P EH
soro|S AO R UW
soror|S UW RRR AO RRR
sorria|S OW0 RH IY AA
sorriso|S OW0 RH IY Z UW
sorriu|S OW0 RH IY W
sorumbático|S OW0 R B AE T IY K UW
sossegado|S UW S EH0 G AE D UW
sossego|S UW S EH0 G UW
sotaina|S OW0 T AE Y N AE
sou|S OW0 W
soul|S OW0 W
sousa|S OW0 W Z AA
souto|S OW0 W T UW
soviético|S OW0 V IY EH T SH IY K UH
splash|IY S P L EH SH IY
splish|IY S P L IY SH IY
stalkear|IY S T AE W K IY AE RH
status|S T AE T UW S
stonehenge|S T OW0 W N HH D
strike|S T R AE Y K
string|EH0 S T R G IY
sua|S UW AA
suarabácti|S W AE R AE B AE K T IY
suaíli|S W AE IY L IY
suba|S UW B AA
subclínico|S UW B K L IY N IY K UW
subdelegacia|S UW B D EH0 L EH0 G AE S IY AA
subdivisão|S UW B IY D IY V IY Z AA W
subentender|S UW B T D EH0 RH
subida|S UW B IY D AA
subir|S UW B IY RH
subjuntivo|S UW B ZH T IY V UW
sublevação|S UW B L EH0 V AE S AA W
sublime|S UW B L IY M IY
submarino|S UW B M AE R IY N UW
submete|S UW B M EH T SH IY
submeter|S UW B M EH0 T EH0 RH
subsistência|S UW B S IY S T S IY AA
substanciar|S UW B S T AA S Y AE RH
substantivo|S UW B SH T AA T IY V UW
substituir|S UW B IY S T SH IY T UW IY RH
substituto|S UW B SH T IY T UW T UW
substância|S UW B S T AA S Y AE
subsídio|S UW B S IY D ZH Y UW
subterfúgio|S UW B T EH0 RRR F UW ZH Y UW
subvencionar|S UW B V S AA W
subversivo|S UW B IY V EH0 RH S IY V UW
subversão|S UW B IY V EH0 RH S AA W
sucatear|S UW K AE T SH IH AE RH
suceder|S UW S EH0 D EH0 RH
sucessivo|S UW S EH0 S IY V UW
sucesso|S UW S EH S UW
sucinto|S UW S T UW
suco|S UW K UW
suculento|S UW K UW L T UW
sucumbir|S UW K B IY RH
sudanesa|S UW D AA N EH0 Z AA
sudanesas|S UW D AA N EH0 Z AA S
sudaneses|S UW D AA N EH0 Z IY S
sudanês|S UW D AA N EH0 Y S
sudeste|S UW D EH SH T IY
sudestino|S UW D EH0 S T IY N UW
suficiente|S UW F IY S IY T SH IY
suficientes|S UW F IY S Y T IY S
suflê|S UW F L EH0
sugerir|S UW ZH EH0 R IY RH
sugestivo|S UW ZH EH0 SH T IY V UW
sugestivos|S UW ZH EH0 S T IY V UW S
suicídio|S UW IY S IY D IY UW
sujeira|S UW ZH EH0 Y R AA
sujeito|S UW ZH EH0 Y T UW
sulco|S UW W K UW
sulfossal|S UW L F UW S AE L
sumiko|S UW M IY K UW
sumiço|S UW M IY S UW
sundanesa|S D AA N EH0 Z AA
sundanesas|S D AA N EH0 Z AA S
sundaneses|S D AA N EH0 Z IY S
sundanês|S D AA N EH0 Y S
suo|S UW UW
superavitário|S UW P EH0 RRR AE V IY T AE RRR Y UW
superciliar|S UW P EH0 RH S IY L IY AE RH
supercílio|S UW P EH0 RH S IY L Y UW
superfície|S UW P EH0 RH F IY S IY
superior|S UW P EH0 R IY OW0 RH
supermercado|S UW P EH0 RH M EH0 RH K AE D UW
superpotência|S UW P EH0 RH P OW0 T S Y AA
superstição|S UW P EH0 RH S T IY S AA W
superveniência|S UW P EH0 R V EH0 N IY S Y AE
superávit|S UW P EH0 RRR AE V IY T SH IY
supimpa|S UW P P AA
suporte|S UW P AO RH T IY
suposição|S UW P OW0 Z IY S AA W
supostamente|S UW P OW0 S T AA M T IY
supremo|S UW P R EH0 M UW
suprimento|S UW P R IY M T UW
suprir|S UW P R IY RH
surfe|S UW RH F IY
surgido|S UW RH ZH IY D UW
surgir|S UW RH ZH IY RH
suricato|S UW R IY K AE T UW
surpresa|S UW RH P R EH0 Z AA
surrão|S UW RH AA W
susana|S UW Z AA N AA
suspeitar|S UW S P EH0 Y T AE RH
sussa|S UW S AA
sussurro|S UW S UW RH UW
sustentar|S UW S T T AE RH
sustentação|S UW S T T AE S AA W
suzuki|S UW Z UW K IY
suábia|S W AE B Y AA
suçuarana|S UW S UW AE R AA N AE
swansea|S W AA S IY
sweep|S W IY P
switch|S W IY T
sydney|S IY D N EH0 Y
sátira|S AE T IY R AE
sânscrito|S AA SH K R IY T UW
sã|S AA
são|S AA W
sé|S EH
sérgio|S EH RH ZH Y UW
sê|S EH0
sídnei|S IY D N EH0 Y
sílvia|S IY W V Y AA
síndrome|S D R OW0 M IY
sísifo|S IY Z IY F UW
sítio|S IY T Y UW
só|S AO
sóbrio|S AO B R Y UW
sódio|S AO D UW
sóror|S AO RRR AO RRR
sósia|S AO Z Y AA
sótão|S AO T AA W
sônia|S OW0 N Y AA
súbita|S UW B IY T AA
súdito|S UW D IY T UW
súplica|S UW P L IY K AA
ta|T AA
tabacaria|T AE B AE K AE R IY AA
tabela|T AE B EH L AA
taboa|T AE B OW0 AA
tabua|T AE B UW AA
tabular|T AA B UW L AE R
tacar|T AE K AE RH
tacha|T AE SH AA
tachar|T AE SH AE RH
tacho|T AE SH UW
taco|T AE K UW
tadeu|T AE D EH0 W
tael|T AE EH W
tahine|T AE IY N IY
taipei|T AE Y P EH0 Y
taiti|T AE IY T IY
tala|T AE L AA
talante|T AE L AA T SH IY
talento|T AE L T UW
talha|T AE L IY AA
talhe|T AE L IY IY
talher|T AE L IY EH RH
talho|T AE L IY UW
talian|T AE L Y AA
talo|T AE L UW
tamanho|T AE M AA N IY0 UW
tamara|T AA M AE R AA
tamareira|T AA M AE R EH0 Y R AA
tambor|T AA B OW0 RH
tamborilar|T AA B OW0 RRR IY L AE R
tamos|T AA M UW S
tanga|T AA G AA
tangerina|T AA ZH IY R IY N AA
tangerineira|T AA ZH IY R IY N EH0 Y R AA
tango|T AA G UW
tangível|T AA ZH IY V EH0 W
tanja|T AA ZH AA
tanquinho|T AA K IY N IY0 UW
tansa|T AA S AA
tanso|T AA S UW
tanta|T AA T AA
tantas|T AA T AA S
tanto|T AA T UW
tantos|T AA T UW S
tantã|T AA T
tapa|T AE P AA
tapete|T AE P EH0 T SH IY
tar|T AE
tardezinha|T AE D IY Z N IY0 AA
tardio|T AE RH D IY W
tareco|T AE RRR EH K UW
tarefa|T AE R EH F AA
taria|T AE R IY AA
tarrafa|T AE RH AE F AE
tarsiliano|T AE R S IY L Y AA N UW
tarso|T AE S OW0
tartu|T AE RH T UW
tarô|T AE R OW0
tasca|T AE S K AA
tascar|T AE S K AE RH
tatiana|T AE T Y AA N AA
tato|T AE T UW
tatu|T AE T UW
tau|T AE W
taurus|T AE W R UW S
tava|T AE V AA
tavam|T AE V AA W
taverna|T AA V EH R N AA
taxa|T AE SH AA
taxo|T AE SH UW
taça|T AE S AA
taís|T AE IY S
taísa|T AE IY Z AA
taíse|T AE IY Z IY
tchau|T AE W
tcheca|T EH K AA
tcheco|T EH K UW
tchecoslováquia|T EH K OW0 Z L OW0 V AE K Y AA
tchê|T EH0
te|T IY
tear|T EH0 AE RH
tecer|T EH0 S EH0 R
tecido|T EH0 S IY D UW
tecla|T EH K L AA
tecladista|T EH0 K L AE D IY S T AA
teclado|T EH0 K L AE D UW
tecnologia|T EH K N OW0 L OW0 ZH IY AA
teco|T EH K UW
teeteto|T EH0 EH0 T EH0 T UW
teia|T EH0 Y AE
teja|T EH0 ZH AA
tejadilho|T EH0 ZH AE D IY L IY UW
teje|T EH0 ZH IY
tela|T EH L AA
telecomandar|T EH L EH0 K OW0 M AA D AE RH
teledramaturgia|T EH L EH0 D R AE M AE T UW RH ZH IY AE
telefonar|T EH0 L EH0 F OW0 N AE RH
telefone|T EH0 L EH0 F N IY
televendas|T EH L EH0 V D AA S
televendedor|T EH L EH0 V D EH0 D OW0 RH
televisor|T EH0 L EH0 V IY Z OW0 RH
televisão|T EH0 L EH0 V IY Z AA W
telhado|T EH0 L IY AE D UW
temente|T EH0 M T IY
temer|T EH0 M EH0 RH
temeste|T EH0 M EH0 S T IY
temeu|T EH0 M EH0 W
tempera|T P EH R AA
temperamento|T P EH0 R AA M T UW
temperatura|T P EH R AE T UW R AA
tempero|T P EH R UW
templo|T P L UW
tempo|T P UW
temporada|T P OW0 R AE D AA
temporão|T P OW0 R AA W
tempurá|T P UW R AE
tempão|T P AA W
tenda|T D AA
tender|T D EH0 RH
tendo|T D UW
tenso|T S UW
tensos|T S UW S
tensão|T S AA W
tenta|T T AA
tentar|T T AE RH
tentativa|T T AE T SH IY V AA
tentação|T T AA S AA W
tento|T T UW
tença|T S AE
tenção|T S AA W
tenência|T EH0 N S Y AE
teobaldo|T EH0 W B AE W D UW
teodoro|T EH0 W D AO R UW
teoria|T EH0 OW0 R IY AA
tera|T EH R AA
terabit|T EH R AE B IY T IY
terabyte|T EH R AE B AE Y T SH IY
tereré|T EH0 R EH0 R EH
tererê|T EH0 R EH0 R EH0
tergiversar|T EH0 R ZH IY V EH0 R S AE RRR
tergiversação|T EH0 R ZH IY V EH0 R S AE S AA W
terminar|T EH0 RH M IY N AE RH
termo|T EH0 RH M UW
ternura|T EH0 R N UW R AE
terremoto|T EH0 RH EH0 M AO T UW
terreno|T EH0 RH EH0 N UW
terrinha|T EH RH IY N IY0 AA
território|T EH IY T AO R Y UW
terrorista|T EH0 RH OW0 R IY S T AA
terráqueo|T EH0 RH AE K Y UW
terrível|T EH0 RH IY V EH0 W
terêncio|T EH0 R S Y UW
tese|T EH Z IY
tesouro|T IY Z OW0 W R UW
tessália|T EH0 S AE L IY AA
testamento|T EH0 SH T AE M T UW
testar|T EH0 S T AE RH
teste|T EH SH T IY
testemunho|T EH0 SH T IY M UW N IY0 UW
testosterona|T EH0 SH T OW0 SH T EH0 R OW0 N AA
teta|T EH T AA
teto|T EH T UW
tetraedro|T EH T R AA EH D R UW
tetraz|T EH0 T R AE Y S
teu|T EH0 W
tez|T EH0 S
teísmo|T EH0 IY Z M UW
teórico|T EH0 AO R IY K UW
thaísa|T AE IY Z AA
thaíse|T AE IY Z IY
ticket|T IY K EH0 T
tifo|T IY F UW
tigela|T IY ZH EH L AA
tigelinha|T IY ZH EH L IY N IY0 AA
timidez|T IY M IY D EH0 Y SH
tina|T IY N AE
tingitano|T ZH IY T AA N UW
tinhoso|T IY Y OW0 Z UW
tinir|T IY N IY RH
tino|T IY N UW
tintim|T T
tinto|T T UW
tintura|T T UW R AA
tipicamente|T IY P IY K AA M T IY
tirano|T IY R AA N UW
tiro|T IY R UW
tirânico|T IY R AA N IY K AE M T IY
titanic|T IY T AA N IY K
titicaca|T IY T IY K AE K AA
toada|T OW0 AE D AA
tocaio|T OW0 K AE Y UW
tocam|T AO K AA W
tocando|T OW0 K AA D UW
tocha|T AO SH AA
togliatti|T OW0 L IY AE T IY
toilette|T OW0 AE L EH T SH IY
tojo|T OW0 ZH UW
tolerar|T OW0 L EH0 R AE RH
tolete|T OW0 L EH0 T IY
tolher|T OW0 L IY EH0 RH
tolo|T OW0 L UW
tolosa|T OW0 L AO Z AA
tom|T
tomada|T OW0 M AE D AA
tomando|T OW0 M AA D UW
tomar|T OW0 M AE RH
tomara|T OW0 M AE R AE
tomateiro|T UW M AE T EH0 Y R UW
tombar|T B AE RH
tomás|T OW0 M AE S
tondela|T D EH L AA
tonelada|T OW0 N EH0 L AE D AA
tonfa|T F AE
tonga|T G AA
tontice|T T IY S IY
tonto|T T UW
tontura|T T UW R AA
tony|T OW0 N IY
top|T AO P IY
tope|T AO P IY
topete|T OW0 P EH T IY
topo|T AO P UW
topzeira|T AO P IY Z EH0 Y R AA
toque|T AO K IY
torcido|T OW0 RH S IY D UW
torengo|T OW0 R G UW
toro|T AO R UW
torpe|T AO R P IY
torrente|T OW0 RH T IY
torto|T OW0 RRR T OW0
toscana|T OW0 S K AA N AA
tosse|T AO S IY
totais|T OW0 T AE Y SH
totalidade|T UW T AE L IY D AE D IY
totem|T AO T Y
touro|T OW0 W R UW
toxicólogo|T AO K S IY K AO L AO G UW
trabalhoso|T R AE B AE L IY OW0 Z UW
trabuco|T R AE B UW K UW
tradutor|T R AE D UW T OW0 RH
traduçãozinha|T R AE D UW S AA W Z IY N IY0 AA
trafalgar|T R AE F AE W G AE RH
tragédia|T R AE ZH EH D Y AA
trai|T R AE Y
traje|T R AE ZH IY
trajo|T R AE ZH UW
tralha|T R AE L IY AA
trama|T R AA M AA
trambicagem|T R B IY K AE ZH
trambicar|T R B IY K AE HR
trambique|T R B IY K IY
trambiqueiro|T R B IY K EH0 Y R UW
tranca|T R AA K AA
tranco|T R AA K UW
trancoso|T R AA K OW0 Z UW
tranquila|T R AA K W IY L AA
tranquilinha|T R AA K W IY L IY N IY0 AA
tranquilinhas|T R AA K W IY L IY N IY0 AA S
tranquilinho|T R AA K W IY L IY N IY0 UW
tranquilinhos|T R AA K W IY L IY N IY0 UW S
tranquilizador|T R AA K W IY L IY Z AE D OW0 RH
tranquilizadora|T R AA K W IY L IY Z AE D OW0 R AA
tranquilo|T R AA K W IY L UW
tranquilona|T R AA K W IY L OW0 N AA
tranquilonas|T R AA K W IY L OW0 N AA S
tranquilão|T R AA K W IY L AA W
tranquilíssima|T R AA K W IY L IY S IY M AA
tranquilíssimas|T R AA K W IY L IY S IY M AA S
tranquilíssimo|T R AA K W IY L IY S IY M UW
tranquilíssimos|T R AA K W IY L IY S IY M UW S
tranquilões|T R AA K W IY L Y S
transa|T R AA Z AA
transar|T R AA Z AE RH
transeunte|T R AA Z EH0 T IY
transeuntes|T R AA Z EH0 T IY S
transferência|T R AA S F EH0 R S Y AA
transfiguro|T RRR S F IY G UW R UW
transitar|T R AA Z IY T AE RH
transitividade|T R AA Z IY T IY V IY D AE D IY
transitivo|T R AA Z IY T IY V UW
transitório|T R AA Z IY T AO R Y UW
transição|T R AA Z IY S AA W
transições|T R AA Z IY S Y SH
transliteração|T R AA S L IY T EH0 R AE S AA W
transmitir|T R AA ZH M IY T SH IY HR
transpassado|T R AA S P AE S AE D UW
transplantar|T R AA S P L AA T AE RH
transporte|T R AA S P AO RH T SH IY
transvaal|T R AA Z V AE W
transversais|T RRR AA Z V EH0 RH S AE Y S
transversal|T RRR AA Z V EH0 RH S AE W
trança|T R AA S AA
trançar|T R AA S AE RH
tranço|T R AA S UW
trapalhada|T R AE P AE L IY AE D AA
trapaça|T R AE P AE S AA
trapo|T R AE P UW
traqueia|T R AE K EH Y AA
traquejar|T R AE K EH0 ZH AE HR
traquejo|T R AE K EH0 ZH UW
trata|T R AE T AA
tratado|T R AE T AE D UW
tratamento|T R AE T AA M T UW
tratar|T R AE T AE RH
trato|T R AE T UW
trauma|T R AE W M AA
trava|T R AE V AA
traveco|T R AE V EH K UW
travessa|T R AE V EH S AA
travesseiro|T R AE V IY S EH0 Y R UW
travessia|T R AE V EH0 S IY AA
travesso|T R AE V EH S UW
travão|T R AE V AA W
traça|T R AE S AA
traço|T R AE S UW
trecho|T R EH0 SH UW
treco|T R EH K UW
treinamento|T R EH0 Y N AA M T UW
treinar|T R EH0 Y N AE RH
treino|T R EH0 Y N UW
tremedeira|T R EH0 M EH0 D EH0 Y R AE
tremura|T R EH0 M UW R AE
trena|T R EH0 N AA
treno|T R EH0 N UW
trenó|T R EH0 N AO
trepadeira|T R EH0 P AE D EH0 Y R AA
trepação|T R EH0 P AE S AA W
trete|T R EH T SH IY
treva|T R EH V AA
trevisan|T R EH0 V IY Z AA
trevo|T R EH0 V UW
tri|T R IY
tribo|T R IY B UW
tricô|T R IY K OW0
trieste|T R IY EH S T IY
trigésimo|T R IY ZH EH Z IY M UW
trilha|T R IY L IY AA
trilho|T R IY L IY UW
trilhão|T R IY L IY AA W
trimestre|T R IY M EH SH T R IY
trinta|T R T AA
tripa|T R IY P AA
tripla|T R IY P L AA
trisavó|T R IY Z AE V AO
trisavô|T R IY Z AE V OW0
triste|T R IY SH T SH IY
tristeza|T R IY SH T EH0 Z AA
tritura|T R IY T UW R AE
trituradora|T R IY T UW R AE D OW0 R AA
trituro|T R IY T UW R UW
tritão|T R IY T AA W
trivialidade|T RRR IY V IY AE L IY D AE D ZH IY
troar|T R OW0 AE R
troca|T R AO K AA
trocadilho|T R OW0 K AE D IY L IY UW
trocado|T R OW0 K AE D UW
troco|T R AO K UW
trofa|T R AO F AA
troll|T R AO W
trololó|T R AO L AO L AO
trom|T R
tromba|T R B AA
trombeta|T R B EH0 T AA
tronco|T R K UW
tropa|T R AO P AA
trotskismo|T R AO T SH K IY SH M UW
trouxa|T R OW0 W SH AA
trouxera|T R OW0 W S EH R AA
trouxeram|T R OW0 W S EH R AA W
trova|T RRR AO V AA
trovar|T RRR UW V AE RRR
troço|T R AO S UW
trufa|T R UW F AA
trunfo|T R F UW
truta|T R UW T AA
tráfego|T R AE F EH0 G UW
tráfico|T R AE F IY K UW
trágico|T RRR AE ZH IY K UW
trânsito|T R AA Z IY T UW
tríplex|T R IY P L EH0 K S
tríptico|T R IY P T IY K UW
trítio|T R IY T Y UW
tu|T UW
tua|T UW AA
tucuxi|T UW K UW SH IY
tucídides|T UW S IY D IY D IY S
tudo|T UW D UW
tufo|T UW F UW
tufão|T UW F AA W
tui|T UW Y
tuitaço|T UW IY T AE S UW
tuiuiú|T UW Y UW Y UW
tulipa|T UW L IY P AA
tumor|T UW M OW0 RH
tundra|T D R AA
tupi|T UW P IY
tupiniquim|T UW P IY N IY K
tupla|T UW P L AA
tupperware|T AA P AA W EH RH
tupã|T UW P AA
turbulento|T UW RH B UW L T UW
turma|T UW RH M AA
turno|T UW RH N UW
turu|T UW R UW
turíbulo|T UW R IY B UW L UW
tussa|T UW S AA
tutela|T UW T EH L AA
tá|T AE
tábua|T AE B W AA
tácito|T AE S IY T UW
tálus|T AE L UW S
tárraco|T AE RH AE K UW
táxi|T AE K S IY
tâmara|T AA M AE R AA
tântalo|T AA T AE L UW
tão|T AA W
técnica|T EH K N IY K AA
técnico|T EH K N IY K UW
tédio|T EH D Y UW
término|T EH RH M IY N UW
tétrico|T EH T R IY K UW
tê|T EH0
têmpora|T P OW0 R AA
tíbia|T IY B Y AA
tímido|T IY M IY D UW
tímpano|T P AA N UW
tímpanos|T P AA N UW S
típico|T IY P IY K UW
tísica|T IY Z IY K AA
tísico|T IY Z IY K UW
tó|T AO
tórax|T AO R AE K S
tóxico|T AO K S IY K UW
tô|T OW0
túlipa|T UW L IY P AA
túmulo|T UW M UW L UW
u|UW
uai|UW AE Y
uapiti|W AE P IY T IY
uau|W AE W
uberrimamente|UW B EH RH IY M AA M T IY
ubicação|UW B IY K AE S AA W
ubérrimo|UW B EH RH IY M UW
ubíquo|UW B IY K W UW
ufa|UW F AA
ufo|UW F OW0
uhul|UW RH UW W
uivo|UW Y V UW
ula|UW L AA
ulna|UW W N AE
ulterior|UW W T EH0 R IY OW0 RH
ultimato|UW W T IY M AE T UW
ultrapassado|UW W T R AE P AE S AE D UW
ultraterreno|UW W T R AE T EH0 RH EH0 N UW
ultravioleta|UW W T R AA V Y OW0 L EH0 T AA
um|
umas|UW M AA SH
umbigada|B IY G AE D AA
umbrais|B R AE Y S
underline|AA D EH0 R L AE Y N IY
undécimo|D EH S IY M UW
unhar|UW N IY0 AE R
unicamente|UW N IY K AE M T IY
unidade|UW N IY D AE D IY
unido|UW N IY D UW
unificação|UW N IY F IY K AE S AA W
unilateralismo|UW N IY L AE T EH0 R AE L IY S M UW
universal|UW N IY V EH0 RH S AE W
universidades|UW N IY V EH0 RRR S IY D AE D ZH IY S
universitária|UW N IY V EH0 RH S IY T AE R Y AA
união|UW N IY AA W
uns|SH
untar|T AE RH
unto|T UW
ununséptio|UW N S EH P T Y UW
ununóctio|UW N UW N AO T Y UW
unção|S AA W
uníssono|UW N IY S OW0 N UW
upar|UW P AE RH
update|AA P IY D EH0 IY T IY
upgrade|AA P IY G R EH0 IY D IY
upload|UW P IY L OW0 W D IY
uppsala|UW P S AE L AA
urbanizar|UW RH B AA N IY Z AE RH
urbano|UW RH B AA N UW
urdir|UW R D IY R
urna|UW RH N AA
uro|UW R UW
urrar|UW RH AE HR
urro|UW RH UW
urubiciense|UW R UW B IY S IY S IY
urucum|UW R UW K
uruguaio|UW R UW G W AE Y UW
urupemense|UW R UW P EH0 M S IY
urutau|UW R UW T AE W
usa|UW Z AA
usam|UW Z AA W
usando|UW Z AA D UW
usara|UW Z AE R AA
usava|UW Z AE V AA
username|Y UW Z EH0 RH N EH0 Y M IY
usina|UW Z IY N AA
uso|UW Z UW
usou|UW Z OW0 W
usso|UW S UW
ustulação|UW S T UW L AE S AA W
usufruto|UW Z UW F R UW T UW
usura|UW Z UW R AE
usuário|UW Z UW AE R Y UW
usável|UW Z AE V EH0 W
utah|Y UW T AE
utilidade|UW T IY L IY D AE D IY
utilização|UW T IY L IY Z AE S AA W
utópico|UW T AO P IY K UW
uva|UW V AA
uzbeque|UW ZH B EH K IY
ué|W EH
uísque|W IY S K IY
vaca|V AE K AA
vacante|V AA K AA T IY
vacilar|V AE S IY L AE R
vacuidade|V AE K UW IY D AE D IY
vadoso|V AE D OW0 Z UW
vagabundagem|V AE G AE B D AE ZH Y
vagabundo|V AE G AE B D UW
vagante|V AA G AA T IY
vai|V AE Y
vaivéns|V AE Y V Y S
vala|V AE L AA
valado|V AE L AE D UW
valentim|V AE L T
valentino|V AE L T IY N UW
valentão|V AE L T AA W
valha|V AE L IY AA
valho|V AE L IY UW
valia|V AE L IY AA
valo|V AE L UW
valorização|V AE L OW0 R IY Z AE S AA W
valáquio|V AE L AE K Y UW
valão|V AE L AA W
vampiro|V AA P IY R UW
vanderlei|V AA D EH0 RH L EH0 Y
vanglória|V AA G L AO R Y AA
vantagem|V AA T AE ZH Y
vantajoso|V AA T AE ZH OW0 Z UW
vaqueiro|V AE K EH0 Y R UW
vara|V AE R AA
varapau|V AE R AE P AE W
varejista|V AE R EH0 ZH IY SH T AA
variar|V AE R IY AE RH
variedade|V AE R Y EH D AE D IH
varonis|V AE R OW0 N IY S
vaso|V AE Z UW
vassalo|V AE S AE L UW
vassili|V AE S IY L IY
vassoura|V AE S OW0 W R AA
vastidão|V AE SH T IY D AA W
vasto|V AE S T UW
vatapá|V AE T AE P AE
vau|V AE W
vaza|V AE Z AA
vazamento|V AE Z AA M T UW
vazio|V AE Z IY W
vazo|V AE Z UW
veado|V IY AE D UW
vedor|V EH0 D OW0 RH
vegano|V EH0 G AA N UW
vegete|V EH0 ZH EH T SH IY
veios|V EH0 Y UW S
vela|V EH L AA
velar|V EH0 L AE RH
velcro|V EH W K RRR UW
veleiro|V IY L EH0 Y R UW
velejar|V EH0 L EH0 ZH AE HR
velha|V EH L IY AA
velhaco|V EH0 L IY AE K UW
velhinho|V EH L IY IY N IY0 UW
velhota|V EH L IY AO T AA
velhote|V EH0 L IY AO T IY
velhão|V EH L IY AA W
velhíssimo|V EH L IY IY S IY M UW
velocidade|V EH0 L OW0 S IY D AE D IY
velocidades|V EH0 L OW0 S IY D AE D IY S
veludo|V EH0 L UW D UW
vencelho|V S EH0 L IY UW
vencer|V S EH0 RH
vencido|V S IY D UW
vencilho|V S IY L IY UW
venda|V D AA
vendas|V D AA S
vender|V D EH0 RH
vendo|V D UW
vendável|V D AE V EH0 W
venial|V EH0 N IY AE W
venta|V T AA
vento|V T UW
ventre|V T R IY
ventura|V T UW R AA
ventã|V T AA
verbasco|V EH0 RH B AE S K UW
verbo|V EH RH B UW
verborragia|V EH R B OW0 RH AE ZH IY AE
verborreia|V EH R B OW0 RH EH Y AE
verbosamente|V EH RH B OW0 Z AA M T IY
verboso|V EH0 RH B OW0 Z UW
verdade|V EH HH D AE D IY
verdadeiramente|V EH0 RH D AE D EH0 Y R AE M T IY
verdadeiro|V EH0 RH D AE D EH0 Y R UW
verear|V EH0 R Y AE RH
vergastada|V EH0 RH G AE S T AE D AA
vermículo|V EH0 RH M IY K UW L UW
vero|V EH R UW
verona|V EH0 R OW0 N AA
versão|V EH0 RH S AA W
versúcia|V EH0 HR S UW S Y AE
verás|V EH0 R AE S
vespeiro|V EH0 SH P EH0 Y R UW
vestibular|V EH0 S T IY B UW L AE RH
vestido|V EH0 S T IY D UW
vestimenta|V EH0 S T IY M T AA
vestir|V IY S T IY RH
vestuário|V EH0 SH T UW AE R Y UW
vesícula|V IY Z IY K UW L AE
vesúvio|V EH0 Z UW V Y UW
vetar|V EH0 T AE RH
veterinário|V EH0 T EH0 R IY N AE RRR Y UW
veto|V EH T UW
vexame|V EH0 SH AA M IY
vezinha|V EH0 Y Z N IY0 AA
vi|V IY
via|V IY AA
viagem|V IY AE ZH Y
viajado|V IY AE ZH AE D UH
viajar|V Y AE ZH AE RH
viatura|V IY AE T UW R AA
victor|V IY K T OW0 RH
videira|V IY D EH0 Y R AA
vidente|V IY D T IY
vidrar|V IY D R AE RH
vidraça|V IY D R AE S AA
vidro|V IY D R UW
vieira|V IY EH0 Y R AA
viela|V IY EH L AA
view|V IY W
vigente|V IY ZH T IY
vigilância|V IY ZH IY L AA S IY AA
vigor|V IY G OW0 RH
vigoroso|V IY G OW0 R OW0 Z UW
vigésimo|V IY ZH EH Z IY M UW
viking|V IY K G IY
vila|V IY L AA
vilancico|V IY L AA S IY K UW
vilhancico|V IY L IY AA S IY K UW
vilipendiar|V IY L IY P D IY AE RH
vilã|V IY L AA
vilão|V IY L AA W
vim|V
vinagreira|V IY N AE G R EH0 Y R AA
vinagrete|V IY N AE G R EH T SH IY
vincilho|V S EH0 L IY UW
vindimar|V D IY M AE RH
vindo|V D UW
vindos|V D UW S
vindouro|V D OW0 W R UW
vingança|V G AA S AA
vinho|V IY N IY0 UW
vini|V IY N IY
vinicultura|V IY N IY K UW W T UW R AA
viola|V IY AO L AA
violação|V Y OW0 L AE S AA W
violentamente|V Y OW0 L T AA M T IY
violento|V Y OW0 L T UW
violinista|V Y UW L IY N IY SH T AA
violoncelo|V Y OW0 L S EH L UW
violão|V IY OW0 L W
violência|V IY OW0 L S Y AA
vira|V IY R AA
viram|V IY R AA W
virar|V IY R AE RH
virgem|V IY RH ZH Y
virgindade|V IY RH ZH D AE D IY
viria|V IY R IY AA
viriam|V IY R IY AA W
virilha|V IY R IY L IY AA
virtuais|V IY RH T UW AE Y S
virtuosos|V IY RH T UW AO Z UW S
virulento|V IY R UW L T UW
virá|V IY R AE
virão|V IY R AA W
visar|V IY Z AE RH
visconde|V IY S K D IY
viseu|V IY Z EH0 W
visita|V IY Z IY T AA
visitar|V IY Z IY T AE RH
vislumbre|V IY Z L B R IY
visom|V IY Z
vista|V IY S T AA
vistoso|V IY S T OW0 Z UW
visualizar|V IY Z W AE L IY Z AE RH
visão|V IY Z AA W
vitamina|V IY T AE M IY N AA
viticultura|V IY T IY K UW W T UW R AA
vitivinicultura|V IY N IY V IY T IY K UW W T UW R AA
vitrificar|V IY T R IY F IY K AE RH
vitória|V IY T AO R Y AA
viu|V IY W
viva|V IY V AA
vivam|V IY V AA W
vivar|V IY V AE RH
vivenciar|V IY V S IY AE RH
vivenda|V IY V D AA
vivendo|V IY V D UW
vivera|V IY V EH0 R AA
viveu|V IY V EH0 W
vivi|V IY V IY
vivia|V IY V IY AA
vivo|V IY V UW
vivência|V IY V S Y AA
vizela|V IY Z EH L AA
vizinhança|V IY Z IY N IY0 AA S AA
viço|V IY S UW
viçoso|V IY S OW0 Z UW
voa|V OW0 W AA
voadora|V W AE D OW0 R AA
voar|V OW0 AE RH
vocabulário|V OW0 K AE B UW L AE R Y UW
você|V OW0 S EH0
vocês|V OW0 S EH0 Y SH
vogar|V OW0 G AE RH
volapuque|V OW0 L AE P UW K IY
voltar|V OW0 W T AE RH
volteio|V OW0 W T EH0 Y UW
voltou|V OW0 W T OW0 W
volume|V AO L UW M IH
volumoso|V UW L UW M OW0 Z UW
voluntário|V UW L T AE R Y UW
volátil|V OW0 L AE T IY W
vontade|V T AE D ZH IY
voo|V OW0 W
voragem|V OW0 R AE ZH Y
voraz|V OW0 R AE Y S
vorazes|V OW0 R AE Z IY S
vossa|V AO S AA
vosso|V AO S UW
vote|V AO T IY
voto|V AO T UW
vou|V OW0 W
vovô|V OW0 V OW0
vozear|V OW0 Z IY AE R
vozes|V AO Z IY SH
voçoroca|V OW0 S OW0 R AO K AE
vukovar|V UW K OW0 V AE RH
vulcanismo|V UW W K AA N IY Z M UW
vulgarmente|V UW W G AE RH M T IY
vulnerar|V UW W N IY R AE RH
vulto|V UW W T UW
vuvuzela|V UW V UW Z EH L AA
vá|V AE
vácuo|V AE K W UW
válido|V AE L IY D UW
vário|V AE R Y UW
vários|V AE R Y UW S
vã|V AA
vão|V AA W
véi|V EH Y
véio|V EH Y UW
véspera|V EH S P EH0 R AA
véu|V EH W
vê|V EH0
víbora|V IY B OW0 R AE
vínico|V IY N IY K UW
víride|V IY R IY D IY
vívido|V IY V IY D UW
vós|V AO Y SH
vômito|V OW0 M IY T UW
w|D AE B L IY UW
washington|W AO SH T
wellington|W EH L T
wolfgang|V OW0 W F G AA G
workshop|W OW0 RH K SH AO P IY
workstation|W OW0 RH K S T EH0 Y SH
worm|W OW0 RH M IY
wuhan|W UW HH AA
wyoming|W AE Y OW0 M
x|SH
xampu|SH AA P UW
xamã|SH AE M AA
xana|SH AA N AA
xangai|SH AA G AE Y
xavasca|SH AE V AE SH K AA
xavecar|SH AE V EH0 K AE RH
xaveco|SH AE V EH K UW
xavier|SH AE V IY EH RH
xelim|SH EH0 L
xereca|SH EH0 R EH K AE
xerocar|SH EH0 R OW0 K AE RH
xerox|SH EH0 R AO K S
xiismo|SH IY IY Z M UW
xiita|SH IY IY T AA
xilindró|SH IY L D R AO
xingava|SH G AE V AA
xituculumucumba|SH IY T UW K UW L UW M UW K B AA
xixa|SH IY SH AA
xota|SH AO T AA
xote|SH AO T IY
xoxota|SH OW0 SH AO T AA
xurumbambo|SH UW R B AA B UW
xá|SH AE
xícara|SH IY K AE R AE
yorkshire|Y AO RH K SH AE Y EH0 RH
yukiko|Y UW K IY K UW
yuko|Y UW K UW
yunnan|Y UW N AA
yuri|Y UW R IY
yuriko|Y UW R IY K UW
zagreb|Z AE G R EH B IY
zagueiro|Z AE G EH0 Y R UW
zanga|Z AA G AA
zangado|Z AA G AE D UW
zangam|Z AA G AA W
zango|Z AA G UW
zangão|Z AA G AA W
zanza|Z AA Z AA
zebra|Z EH0 B R AA
zebro|Z EH0 B R UW
zebu|Z EH0 B UW
zelador|Z EH0 L AE D OW0 RH
zelda|Z EH W D AA
zelo|Z EH L UW
zeloso|Z EH0 L OW0 Z UW
zepelim|Z EH0 P EH0 L
zero|Z EH R UW
zeugma|Z EH0 W G IY M AA
zica|Z IY K AA
zigoma|Z IY G OW0 M AE
zigoto|Z IY G AO T UW
zilhão|Z IY L IY AA W
zimbro|Z B R UW
zinco|Z K UW
zincografia|Z K OW0 G R AE F IY AE
zodíaco|Z OW0 D IY AE K UW
zona|Z N AA
zoneamento|Z OW0 N IY AA M T UW
zoo|Z OW0 W
zoofilia|Z OW0 OW0 F IY L IY AA
zoologia|Z OW0 OW0 L OW0 ZH IY AA
zoológico|Z OW0 OW0 L AO ZH IY K UW
zoom|Z
zootecnia|Z OW0 OW0 T EH K N IY AA
zoólogo|Z OW0 AO L OW0 G UW
zuca|Z UW K AA
zulu|Z UW L UW
zumbi|Z B IY
zumbido|Z B IY D UW
zumbir|Z B IY RH
zunzum|Z Z
zurrapa|Z UW RH AE P AA
zâmbia|Z AA B Y AA
zângão|Z AA G AA W
zé|Z EH
zéfiro|Z EH F IY R UW
zénite|Z EH0 N IY T IY
zê|Z EH0
à|AE
àquela|AE K EH L AA
àquelas|AE K EH L AA SH
àquele|AE K EH0 L IY
àqueles|AE K EH0 L IY SH
àquilo|AE K IY L UW
á|AE
ádito|AE D IY T UW
áfrica|AE F R IY K AA
ágrafo|AE G R AE F UW
álamo|AE L AA M UW
álcool|AE W K AO W
árabe|AE R AE B IY
árbitro|AE RH B IY T R UW
árido|AE R IY D UW
ás|AE S
ásia|AE Z Y AA
átrio|AE T R Y UW
â|AA
âmbito|AA B IY T UW
âncora|AA K OW0 R AA
ânfora|AA F OW0 R AA
ângulo|AA G UW L UW
ã|AA
ç|S
é|EH
éfeso|EH F EH0 Z UW
época|EH P UW K AA
érica|EH R IY K AA
ética|EH T IY K AA
étimo|EH T IY M UW
étnico|EH T N IY K UW
ênclise|K L IY Z IY
ênfase|F AA Z IY
ícone|IY K OW0 N IY
íeis|IY EH0 Y S
ímpeto|P EH0 T UW
ímprobo|P R OW0 B UW
índice|D ZH IY S IY
ínsula|S UW L AA
íntimo|T IY M UW
ípsilon|IY P S IY L
ístria|IY S T R IY AA
ó|AO
óculo|AO K UW L UW
óculos|AO K UW L UW S
óleo|AO L IY UW
óliver|AO L IY V EH0 RH
óptico|AO P T IY K UW
ósseo|AO S IY UW
óvni|AO V N IY
ô|OW0
õ|
ú|UW
úlcera|UW W S EH0 R AA
úngula|G UW L AA
único|UW N IY K UW
úrsula|UW RH S UW L AA
útero|UW T EH0 R UW
útil|UW T IY L