ء|Q
آ|Q AE
آبد|Q AE B IY D
آبيس|Q AE B IY S
آتشيوت|Q AE T SH IY Y OW0 T
آتون|Q AE T UW N
آخر|Q AE HH IY RRR
آخرة|Q AE HH RRR AE
آخن|Q AE HH AE N
آدب|Q AE D IY B
آدم|Q AE D AE M
آدمي|Q AE D AE M IY Y Y
آذان|Q AE DH AE N
آذريون|Q AE DH AE RRR Y UW N
آذى|Q AE DH AE
آس|Q AE S
آسفي|Q AE S AE F IY
آسيوي|Q AE S IY Y AE W IY Y Y
آش|Q AE SH
آشوري|Q AE SH UW RRR IY Y Y
آفات|Q AE F AE T
آل|Q AE L UW
آلات|Q AE L AE T
آلة|Q AE L AE
آمال|Q AE M AE L
آمن|Q AE M UW N UW
آمون|Q AE M UW N
آمين|Q AE M IY N AE
آنسة|Q AE N IY S AE
آنك|Q AE N UW K
آني|Q AE N IY Y Y
آية|Q AE Y AE
آيسلندا|Q AE Y IY S L AE N D AE
آيوا|Q AE Y UW W AE
أ|Q UW
أب|Q AE B
أباجور|Q AE B AE ZH UW RRR
أباخس|Q AE B AE HH IY S UW
أباد|Q AE B AE D AE
أباريق|Q AE B AE RRR IY K
أباس|Q UW B AE S
أباسخيرون|Q AE B AE S HH IY RRR UW N
أبان|B AE N AE
أبتر|Q AE B T AE RRR
أبث|Q AE B AE TH AE
أبخق|Q AE B HH AE K
أبد|Q AE B D UW
أبدا|Q AE B AE D AE N
أبدى|Q AE B D AE
أبدي|Q AE B AE D IY Y Y
أبدية|Q AE B AE D IY Y Y AE
أبر|Q AE B AE RRR RRR AE
أبرز|Q AE B RRR UW Z AE
أبريل|Q AE B RRR IY L
أبسطة|Q AE B S IY T AE
أبش|Q AE B AE SH SH UW
أبطل|Q AE B T AE L AE
أبكم|Q AE B K AE M
أبلس|Q AE B L AE S AE
أبله|Q AE B L AE HH
أبنوس|Q AE B N UW S
أبها|Q AE B HH AE
أبهة|Q UW B B AE HH AE
أبهج|Q AE B HH AE D AE
أبوت|Q UW B UW T
أبيدجان|Q AE B IY D D AE N
أبيض|Q AE B Y AE D
أتاح|Q AE T AE HH AE
أترج|Q UW T RRR UW D D
أتقن|Q AE T K AE N AE
أتلف|Q AE T L AE F AE
أتوبوس|Q OW0 T OW0 B UW S
أتوبيس|Q OW0 T OW0 B IY S
أتوم|Q AE T UW M
أتون|Q AE T T UW N
أتى|Q AE T AE
أثاث|Q AE TH AE TH
أثث|Q AE TH TH AE TH AE
أثجل|Q AE TH D AE L
أثرة|Q UW TH RRR AE
أثل|Q UW TH UW L
أثناء|Q AE TH N AE Q AE
أثينا|Q AE TH IY N AE
أثيوبيا|Q AE TH IY Y UW B IY Y AE
أجاب|Q UW D AE B UW
أجار|Q AE D AE RRR AE
أجدب|Q AE D D AE B
أجذاع|Q AE D DH AE RH
أجرب|Q AE D RRR AE B
أجرد|Q AE D RRR AE D
أجزاء|Q AE D Z AE Q
أجل|Q AE D L
أجلح|Q AE D L AE HH
أجمة|Q AE D AE M AE
أجمع|Q AE D M AE RH AE
أجنبي|Q AE D N AE B IY Y Y
أجهد|Q AE D HH AE D AE
أجهض|Q AE D HH AE D AE
أجوف|Q AE D W AE F
أجيال|Q AE D Y AE L
أحادي|Q UW HH AE D IY Y Y
أحاط|Q UW HH AE T UW
أحب|Q AE HH AE B B AE
أحبك|Q UW HH IY B B UW K IY
أحجم|Q AE HH D AE M AE
أحجية|Q UW HH D IY Y Y AE
أحد|Q AE HH AE D D
أحرج|Q AE HH RRR AE D AE
أحرش|Q AE HH RRR AE SH
أحسن|Q UW HH AE S S IY N UW
أحمر|Q AE HH M AE RRR
أحمق|Q AE HH M AE K
أحور|Q AE HH W AE RRR
أحول|Q AE HH W AE L
أحيلى|Q UW HH AE Y L AE
أخ|Q AE HH
أخاديد|Q AE HH AE D IY D
أخاذ|Q AE HH HH AE DH
أخامص|Q AE HH AE M IY S
أخبر|Q AE HH B AE RRR AE
أخت|Q UW HH T
أخثاث|Q AE HH TH AE TH
أخدر|Q AE HH D AE RRR AE
أخدود|Q UW HH D UW D
أخذ|Q AE HH DH
أخرس|Q AE HH RRR AE S AE
أخشن|Q AE HH SH AE N
أخصائي|Q AE HH IY S S AE Q IY Y Y
أخضر|Q AE HH D AE RRR
أخطأ|Q AE HH T AE Q AE
أخطبوط|Q UW HH T UW B UW T
أخلاط|Q AE HH L AE T
أخلاقي|Q AE HH L AE K IY Y Y
أخلاقية|Q AE HH L AE K IY Y Y AE
أخمص|Q AE HH M UW S
أخوية|Q AE HH AE W IY Y Y AE
أخياط|Q AE HH Y AE T
أخيرى|Q UW HH AE Y RRR AE
أدار|Q AE D AE RRR AE
أدان|Q AE D AE N AE
أدب|Q AE D D AE B AE
أدبة|Q AE D AE B AE
أدبي|Q AE D D IY B IY
أدحوة|Q UW D HH UW W W AE
أدحية|Q UW D HH IY Y Y AE
أدرك|Q AE D RRR AE K AE
أدكن|Q AE D K AE N
أدمن|Q AE D M AE N AE
أدهش|Q UW D HH IY SH UW
أدوية|Q AE D W IY Y AE
أديب|Q AE D IY B
أديبة|Q AE D IY B AE
أذاع|Q AE DH AE RH AE
أذربيجان|Q AE DH AE RRR B AE Y D AE N
أذن|Q UW DH UW N
أذى|Q AE DH AE N
أراد|Q AE RRR AE D AE
أربعة|Q AE RRR B IY RH AE
أربعون|Q AE RRR B AE RH UW N AE
أرثوذكسي|Q UW RRR TH UW DH UW K S IY Y Y
أرجان|Q AE RRR D AE N
أرجواني|Q UW RRR D UW W AE N IY Y Y
أرجيش|Q AE RRR D IY SH
أرح|Q AE RRR AE HH HH
أرخبيل|Q AE RRR HH AE B IY L
أردف|Q AE RRR D AE F AE
أردمون|Q AE RRR D AE M UW N
أردني|Q UW RRR D UW N N IY Y Y
أرز|Q UW RRR UW Z Z
أرسطو|Q AE RRR IY S T UW
أرسطوطاليس|Q AE RRR IY S T UW T AE L IY S
أرسل|Q AE RRR S AE L AE
أرصفة|Q AE RRR S IY F AE
أرض|Q AE RRR D
أرضة|Q AE RRR AE D AE
أرضي|Q AE RRR D IY Y Y
أرغان|Q AE RRR HH AE N
أرغفة|Q AE RRR HH IY F AE
أرقان|Q AE RRR G AE N
أركان|Q AE RRR K AE N
أركن|Q AE RRR K UW N
أركنساس|Q AE RRR K AE N S AE S
أرمل|Q AE RRR M AE L AE
أرمية|Q UW RRR M IY Y AE
أرمينيا|Q AE RRR M IY N IY Y AE
أرنؤدي|Q AE RRR N AE Q UW D IY Y Y
أرنب|Q AE RRR N AE B
أرهب|Q AE RRR HH AE B AE
أرومة|Q UW RRR UW M AE
أرومية|Q UW RRR UW M IY Y AE
أريج|Q AE RRR IY D
أريحا|Q AE RRR IY HH AE
أريزونا|Q AE RRR IY Z UW N AE
أريكا|Q AE RRR IY K AE
أريكة|Q AE RRR IY K AE
أزأم|Q AE Z Q AE M AE
أزاح|Q AE Z AE HH AE
أزادرخت|Q AE Z AE D AE RRR HH AE T
أزب|Q AE Z AE B B
أزدرخت|Q AE Z D AE RRR HH AE T
أزرع|Q AE Z RRR AE RH AE
أزرق|Q AE Z RRR AE G
أزعج|Q AE Z RH AE D AE
أزعر|Q AE Z RH AE RRR
أزلي|Q AE Z AE L IY Y Y
أسارون|Q AE S AE RRR UW N
أساس|Q AE S AE S
أساسي|Q AE S AE S IY Y Y
أسباب|Q AE S B AE B
أسبوع|Q UW S B UW RH
أسبوعي|Q UW S B UW RH IY Y Y
أستاذ|Q UW S T AE DH
أسترالي|Q UW S T UW RRR AE L IY Y Y
أستراليا|Q UW S T UW RRR AE L IY Y AE
أسرب|Q UW S RRR UW B
أسرة|Q UW S RRR AE
أسري|Q UW S RRR IY Y Y
أسس|Q AE S S AE S AE
أسطرك|Q AE S T AE RRR AE K
أسطرلاب|Q AE S T UW RRR L AE B
أسطمة|Q UW S T UW M M AE
أسطوانة|Q UW S T UW W AE N AE
أسطورة|Q UW S T UW RRR AE
أسطوري|Q UW S T UW RRR IY Y Y
أسطول|Q UW S T UW L
أسف|Q AE S IY F AE
أسفاراج|Q AE S F AE RRR AE D
أسفر|Q AE S F AE RRR AE
أسفراج|Q AE S F AE RRR AE D
أسفلت|Q AE S F AE L T
أسفنيك|Q AE S F AE N IY K
أسقف|Q UW S K UW F F
أسكفة|Q UW S K UW F F AE
أسلوب|Q UW S L UW B
أسماء|Q AE S M AE Q
أسمر|Q AE S M AE RRR
أسمرا|Q AE S M AE RRR AE
أسمرة|Q AE S M AE RRR AE
أسهر|Q AE S HH AE RRR AE
أسهل|Q UW S AE HH HH IY L UW
أسوأ|Q AE S W AE Q
أسوة|Q UW S W AE
أسود|Q UW S UW D
أسى|Q AE S AE N
أسياخ|Q AE S Y AE HH
أسيتون|Q AE S IY T UW N
أسير|Q AE S IY RRR
أشابة|Q UW SH AE B AE
أشار|Q AE SH AE RRR AE
أشبع|Q AE SH B AE RH AE
أشترغار|Q UW SH T UW RRR HH AE RRR
أشخص|Q AE SH HH AE S AE
أشرفي|Q AE SH RRR AE F IY Y Y
أشعل|Q AE SH RH AE L AE
أشقر|Q AE SH G AE RRR
أشكل|Q AE SH K AE L
أشل|Q AE SH L
أشم|Q AE SH AE M M AE
أشمط|Q AE SH M AE T
أشنان|Q UW SH N AE N
أشنة|Q UW SH N AE
أشهب|Q AE SH HH AE B
أشهد|Q AE SH HH AE D AE
أشهل|Q AE SH HH AE L
أشوس|Q AE SH W AE S
أشوه|Q AE SH W AE HH
أشيب|Q AE SH Y AE B
أصأب|Q AE S Q AE B AE
أصبح|Q AE S B AE HH
أصحاح|Q AE S HH AE HH
أصحى|Q AE S HH AE
أصخد|Q AE S HH AE D AE
أصخر|Q AE S HH AE RRR AE
أصدأ|Q AE S D AE Q
أصطرك|Q AE S T AE RRR AE K
أصغى|Q AE S HH AE
أصف|Q AE S AE F
أصفاد|Q AE S F AE D
أصفر|Q AE S F AE RRR AE
أصفهان|Q AE S F AE HH AE N
أصلع|Q AE S L AE RH
أصم|Q AE S AE M M
أصهب|Q AE S HH AE B AE
أصيص|Q AE S IY S
أضاع|Q AE D AE RH AE
أضاف|Q AE D AE F AE
أضر|Q AE D AE RRR RRR AE
أضمر|Q AE D M AE RRR AE
أطاح|Q AE T AE HH AE
أطاق|Q AE T AE K AE
أطباء|Q AE T IY B B AE Q
أطبة|Q AE T IY B B AE
أطرش|Q AE T RRR AE SH
أطروحة|Q UW T RRR UW HH AE
أطفال|Q AE T F AE L
أطل|Q AE T AE L L AE
أطلس|Q AE T L AE S
أطلسي|Q AE T L AE S IY Y Y
أطلع|Q AE T L AE RH AE
أطنب|Q AE T N AE B AE
أطيان|Q AE T Y AE N
أعاجيب|Q AE RH AE D IY B
أعاصير|Q AE RH AE S IY RRR
أعتاب|Q AE RH T AE B
أعتن|Q AE RH T AE N AE
أعجم|Q AE RH D AE M AE
أعجمي|Q AE RH D IY M IY
أعجوبة|Q UW RH D UW B AE
أعذب|Q AE RH DH AE B AE
أعرج|Q AE RH RRR AE D
أعرن|Q AE RH RRR AE N AE
أعز|Q AE RH AE Z Z AE
أعزب|Q AE RH Z AE B
أعزل|Q AE RH Z AE L
أعصر|Q AE RH S AE RRR AE
أعض|Q AE RH AE D D AE
أعطاب|Q AE RH T AE B
أعطب|Q AE RH T AE B AE
أعطى|Q AE RH T AE
أعظ|Q AE RH AE DH DH AE
أعف|Q AE RH AE F F AE
أعفر|Q AE RH F AE RRR
أعقد|Q AE RH G AE D
أعل|Q AE RH AE L L AE
أعلن|Q AE RH L AE N AE
أعلى|Q UW RH L AE
أعمدة|Q AE RH M IY D AE
أعمى|Q UW RH AE M M AE
أعور|Q AE RH W AE RRR
أعيا|Q AE RH Y AE
أعياد|Q AE RH Y AE D
أعيان|Q AE RH Y AE N
أغار|Q AE HH AE RRR AE
أغافت|Q AE HH AE F IY T
أغافث|Q AE HH AE F IY TH
أغبر|Q AE HH B AE RRR
أغرق|Q AE HH RRR AE K AE
أغرم|Q AE HH RRR AE M AE
أغرى|Q AE HH RRR AE
أغسطس|Q AE HH UW S T UW S
أغضب|Q AE HH D AE B AE
أغلب|Q UW HH L AE B UW
أغلف|Q AE HH L AE F
أغلفة|Q AE HH L IY F AE
أغماد|Q AE HH M AE D
أغمي|Q UW HH M IY Y AE
أغوى|Q AE HH W AE
أغيد|Q AE HH Y AE D
أفؤل|Q AE F Q UW L
أفاد|Q AE F AE D AE
أفاويه|Q AE F AE W IY HH
أفتى|Q AE F T AE
أفرط|Q AE F RRR AE T AE
أفرع|Q AE F RRR UW RH
أفرغ|Q AE F RRR AE HH AE
أفريقانية|Q AE F RRR IY K AE N IY Y Y AE
أفريقيا|Q AE F RRR IY K Y AE
أفسنتين|Q AE F S IY N T IY N
أفطس|Q AE F T AE S
أفعى|Q AE F RH AE N
أفغانستان|Q AE F HH AE N IY S T AE N
أفغاني|Q AE F HH AE N IY Y Y
أفقي|Q UW F UW K IY Y Y
أفك|Q AE F AE K AE
أفل|Q AE F AE L AE
أفلاطون|Q AE F L AE T UW N
أفلاطوني|Q AE F L AE T UW N IY Y Y
أفلس|Q AE F L AE S AE
أفيون|Q AE F Y UW N
أقحوان|Q UW K HH UW W AE N
أقدر|Q AE K D AE RRR AE
أقر|Q AE K IY RRR
أقرأ|Q AE K RRR AE Q AE
أقرب|Q AE K RRR AE B AE
أقرع|Q AE K RRR AE RH
أقضب|Q AE K D AE B AE
أقضى|Q UW K D AE
أقط|Q AE K IY T
أقعب|Q AE K RH UW B
أكاذيب|Q AE K AE DH IY B
أكار|Q AE K K AE RRR
أكاف|Q UW K K AE F
أكب|Q AE K AE B B AE
أكتوبر|Q UW K T UW B IY RRR
أكثرية|Q AE K TH AE RRR IY Y Y AE
أكرى|Q AE K RRR AE
أكسجين|Q UW K S IY D IY N
أكسح|Q AE K S AE HH
أكسد|Q AE K S AE D AE
أكسدة|Q AE K S AE D AE
أكسيد|Q UW K S IY D
أكشف|Q AE K SH AE F AE
أكل|Q UW K UW L
أكمة|Q AE K AE M AE HH
أكمون|Q AE K M UW N
أكيد|Q AE K IY D
ألا|Q AE L L AE
ألاباما|Q AE L AE B AE M AE
ألاسكا|Q AE L AE S K AE
ألباني|Q AE L B AE N IY Y Y
ألبانيا|Q AE L B AE N IY Y AE
ألغى|Q AE L HH AE
ألف|Q AE L IY F
ألفبائي|Q AE L IY F B AE Q IY Y Y
ألفية|Q AE L F IY Y Y AE
ألقى|Q AE L K AE
ألكسندروس|Q AE L IY K S AE N D AE RRR UW S
ألم|Q AE L AE M
ألماس|Q AE L M AE S
ألماني|Q AE L M AE N IY Y Y
ألمانيا|Q AE L M AE N IY Y AE
ألمح|Q AE L M AE HH AE
أله|Q AE L L AE HH AE
ألهى|Q AE L HH AE
ألوة|Q AE L W AE
ألوهية|Q UW L UW HH IY Y Y AE
ألية|Q AE L Y AE
أليس|Q AE L Y AE S
أم|Q UW M M
أما|Q AE M M AE
أمات|Q AE M AE T AE
أمازيغ|Q AE M AE Z IY HH
أمازيغي|Q AE M AE Z IY HH IY Y Y
أمازيغية|Q AE M AE Z IY HH IY Y Y AE
أمامي|Q AE M AE M IY Y Y
أمان|Q AE M AE N
أمدمي|Q UW M D AE M IY Y Y
أمراء|Q UW M AE RRR AE Q
أمريكا|Q AE M RRR IY K AE
أمريكي|Q AE M RRR IY K IY Y Y
أمس|Q UW M AE S S UW
أمستردام|Q AE M S T IY RRR D AE M
أمسك|Q AE M S AE K AE
أمسوخ|Q UW M S UW HH
أمصوخ|Q UW M S UW HH
أمضى|Q AE M D AE
أمغر|Q AE M HH AE RRR AE
أمكن|Q AE M K AE N AE
أملج|Q AE M L AE D
أملس|Q AE M L AE S
أممي|Q UW M AE M IY Y Y
أمهري|Q AE M HH AE RRR IY Y Y
أمهل|Q AE M HH AE L AE
أموي|Q UW M AE W IY Y Y
أمي|Q UW M M IY
أميبا|Q AE M IY B AE
أميبي|Q AE M IY B IY Y Y
أمير|Q AE M IY RRR
أميرة|Q AE M IY RRR AE
أميركي|Q AE M EH0 RRR IY K IY Y Y
أميل|Q AE M Y AE L
أن|Q AE N N AE
أنا|Q AE N AE
أناخ|Q AE N AE HH AE
أناس|Q UW N AE S
أناغالس|Q AE N AE HH AE L IY S
أناغاليس|Q AE N AE HH AE L IY S
أناغلس|Q AE N AE HH AE L IY S
أناقة|Q AE N AE K AE
أناني|Q AE N AE N IY Y Y
أنباء|Q AE N B AE Q
أنباض|Q AE N B AE D
أنبج|Q AE M B IY D
أنبذ|Q AE N B AE DH AE
أنبوب|Q UW N B UW B
أنبوبة|Q UW N B UW B AE
أنبيق|Q AE N B IY K
أنت|Q AE N T IY
أنتج|Q AE N T AE D AE
أنتم|Q AE N T UW M
أنتما|Q AE N T UW M AE
أنتن|Q AE N T UW N N AE
أنتيكخانة|Q AE N T IY K HH AE N AE
أنثوي|Q UW N TH AE W IY Y Y
أنثى|Q UW N TH AE
أنجدان|Q AE N D UW D AE N
أنجى|Q AE N D AE
أندر|Q AE N D AE RRR AE
أندراوس|Q AE N D AE RRR AE W UW S
أنزروت|Q AE N Z AE RRR UW T
أنزع|Q AE N Z AE RH AE
أنزل|Q AE N Z AE L AE
أنس|Q AE N AE S AE
أنسون|Q AE N S UW N
أنسى|Q AE N S AE
أنصح|Q AE S B AE HH AE
أنضب|Q AE N D AE B AE
أنضج|Q AE N D AE D AE
أنطاكية|Q AE N T AE K IY Y Y AE
أنطاليا|Q AE N T AE L IY Y AE
أنعل|Q AE N RH UW L
أنعم|Q AE N RH UW M
أنغولا|Q AE N HH OW0 L AE
أنف|Q UW N F AE
أنفاق|Q UW N F AE K
أنفحة|Q AE N F IY HH AE
أنفق|Q AE N F AE K AE
أنقذ|Q AE N K AE DH AE
أنقض|Q AE N K AE D IY
أنكر|Q AE N K AE RRR AE
أنما|Q AE N N AE M AE
أنملة|Q AE N M AE L AE
أنموذج|Q UW N M UW DH AE D
أنهك|Q AE N HH AE K AE
أنهى|Q AE N HH AE
أنوار|Q AE N W AE RRR
أنواط|Q AE N W AE T
أنواع|Q AE N W AE RH
أنور|Q AE N W AE RRR
أنوق|Q AE N UW K
أنيسون|Q AE N IY S UW N
أنيون|Q AE N Y UW N
أهبة|Q UW HH B AE
أهدب|Q AE HH D AE B AE
أهدى|Q AE HH D AE
أهر|Q AE HH RRR
أهلا|Q AE HH L AE N
أهلي|Q AE HH L IY Y Y
أهلية|Q AE HH L IY Y Y AE
أهوج|Q AE HH W AE D
أهيف|Q AE HH Y AE F
أو|Q AE W
أوبرا|Q UW B IY RRR AE
أوتاوا|Q OW0 T AE W AE
أوتوماتيكي|Q UW T UW M AE T IY K IY Y Y
أوج|Q AE W D
أوجد|Q UW D AE D UW
أوجز|Q AE W D AE Z AE
أوجس|Q AE W D AE S AE
أوجع|Q AE W D AE RH AE
أوحال|Q AE W HH AE L
أوحد|Q AE W HH AE D
أوحل|Q AE W HH AE L AE
أودى|Q AE W D AE
أور|Q UW RRR
أوراق|Q AE W RRR AE K
أورانوس|Q UW RRR AE N UW S
أورانيا|Q AE W RRR AE N IY Y AE
أورانيوم|Q UW RRR AE N Y UW M
أوركسترا|Q OW0 RRR K EH0 S T RRR AE
أوروبا|Q UW RRR UW B B AE
أوروبي|Q UW RRR UW B B IY Y Y
أوروغواي|Q UW RRR UW HH UW W AE Y
أورى|Q AE W RRR AE
أوريغون|Q UW RRR IY HH UW N
أوزبكستان|Q UW Z B AE K IY S T AE N
أوساكا|Q UW S AE K AE
أوشك|Q AE W SH AE K AE
أوصى|Q AE W S AE
أوضح|Q AE W D AE HH AE
أوعية|Q AE W RH IY Y AE
أوغندا|Q UW HH AE N D AE
أوقد|Q AE W K AE D AE
أوقف|Q AE W K AE F AE
أوقية|Q UW K IY Y Y AE
أوكرانيا|Q UW K RRR AE N IY Y AE
أوكلاهوما|Q UW K L AE HH UW M AE
أوكيناوا|Q UW K IY N AE W AE
أول|Q AE W W AE L
أولئك|Q UW L AE Q IY K AE
أولمبي|Q UW L IY M B IY Y Y
أولو|Q UW L UW
أولى|Q UW L AE
أولي|Q AE W W AE L IY Y Y
أولياء|Q AE W L IY Y AE Q
أونسة|Q UW N S AE
أونصة|Q UW N S AE
أي|Q AE Y Y
أياد|Q AE Y AE D IY N
أيام|Q AE Y Y AE M
أيرلندا|Q AE Y IY RRR L AE N D AE
أيش|Q AE Y SH IY N
أيقظ|Q AE Y K AE DH AE
أيقن|Q AE Y K AE N AE
أيل|Q UW Y Y AE L
أيلول|Q AE Y L UW L
أين|Q AE Y N AE
أيهقان|Q AE Y HH UW K AE N
أيوب|Q AE Y Y UW B
أيوبي|Q AE Y Y UW B IY Y Y
أيون|Q AE Y UW N
ؤ|Q UW
إ|Q IY
إباحة|Q IY B AE HH AE
إباحي|Q IY B AE HH IY Y Y
إباحية|Q IY B AE HH IY Y Y AE
إبادة|Q IY B AE D AE
إبالة|Q IY B B AE L AE
إبان|Q IY B B AE N AE
إبتات|Q IY B T AE T
إبجال|Q IY B D AE L
إبداعي|Q IY B D AE RH IY Y Y
إبراهيم|Q IY B RRR AE HH IY M
إبرة|Q IY B RRR AE
إبريز|Q IY B RRR IY Z
إبريسم|Q IY B RRR AE Y S AE M
إبريق|Q IY B RRR IY G
إبريل|Q IY B RRR IY L
إبزيم|Q IY B Z IY M
إبطاء|Q IY B T AE Q
إبعاد|Q IY B RH AE D
إبل|Q IY B IY L
إبليز|Q IY B L IY Z
إبليس|Q IY B L IY S
إبليسي|Q IY B L IY S IY Y Y
إبيقوري|Q IY B IY K UW RRR IY Y Y
إتاحة|Q IY T AE HH AE
إتاوة|Q IY T AE W AE
إتقان|Q IY T K AE N
إتلاف|Q IY T L AE F
إثبات|Q IY TH B AE T
إثمد|Q IY TH M IY D
إثيوبيا|Q IY TH Y UW B IY Y AE
إجازة|Q IY D AE Z AE
إجاص|Q IY D D AE S
إجاصة|Q IY D D AE S AE
إجبار|Q IY D B AE RRR
إجباري|Q IY D B AE RRR IY Y Y
إجمالي|Q IY D M AE L IY Y Y
إجهاض|Q IY D HH AE D
إحارة|Q IY HH AE RRR AE
إحاطة|Q IY HH AE T AE
إحدى|Q IY HH D AE
إحسان|Q IY HH S AE N
إحصائي|Q IY HH S AE Q IY Y Y
إدارة|Q IY D AE RRR AE
إداري|Q IY D AE RRR IY Y Y
إدحية|Q IY D HH IY Y AE
إدريس|Q IY D RRR IY S
إدهاش|Q IY D HH AE SH
إذ|Q IY DH
إذا|Q IY DH AE
إذاعة|Q IY DH AE RH AE
إذخر|Q IY DH HH IY RRR
إذما|Q IY DH M AE
إرادي|Q IY RRR AE D IY Y Y
إربيان|Q IY RRR B IY Y AE N
إرتريا|Q IY RRR IY T RRR IY Y AE
إردب|Q IY RRR D AE B B
إرزيز|Q IY RRR Z IY Z
إرهاب|Q IY RRR HH AE B
إرهابي|Q IY RRR HH AE B IY Y Y
إرهاق|Q IY RRR HH AE K
إريس|Q IY RRR RRR IY S
إزاء|Q IY Z AE Q AE
إزار|Q IY Z AE RRR
إزالة|Q IY Z AE L AE
إزعاج|Q IY Z RH AE D
إزميل|Q IY Z M IY L
إسبانيا|Q IY S B AE N IY Y AE
إسبانية|Q IY S B AE N IY Y AE
إسبغول|Q IY S B AE HH OW0 L
إستاد|Q IY S T AE D
إستار|Q IY S T AE RRR
إستبرق|Q IY S T AE B RRR AE K
إستديو|Q IY S T IY D Y OW0
إستوديو|Q IY S T UW D IY Y OW0
إستوكهولم|Q IY S T UW K HH UW L M
إستونيا|Q IY S T OW0 N IY Y AE
إسحاق|Q IY S HH AE K
إسرائيل|Q IY S RRR AE Q IY L
إسرائيلي|Q IY S RRR AE Q IY L IY Y Y
إسرنج|Q IY S RRR IY N D
إسطبل|Q IY S T AE B L
إسطرك|Q IY S T AE RRR AE K
إسفنط|Q IY S F IY N T
إسفيدباج|Q IY S F IY D AE B AE D
إسقنقور|Q IY S K AE N K UW RRR
إسكاف|Q IY S K AE F
إسكتلندا|Q IY S K UW T L AE N D AE
إسكتلندي|Q IY S K UW T L AE N D IY Y Y
إسكندراني|Q IY S K AE N D AE RRR AE N IY Y Y
إسلام|Q IY S L AE M
إسماعيل|Q IY S M AE RH IY L
إسماعيلي|Q IY S M AE RH IY L IY Y Y
إسناد|Q IY S N AE D
إسوة|Q IY S W AE
إشبيلية|Q IY SH B IY L Y AE
إشبين|Q IY SH B IY N
إشبينة|Q IY SH B IY N AE
إشعاعي|Q IY SH RH AE RH IY Y Y
إشغال|Q IY SH HH AE L
إشفى|Q IY SH F AE
إشهار|Q IY SH HH AE RRR
إصبع|Q IY S B AE RH
إصطبل|Q IY S T AE B L
إصطرك|Q IY S T AE RRR AE K
إصقنقور|Q IY S K AE N K UW RRR
إضافة|Q IY D AE F AE
إطار|Q IY T AE RRR
إطراء|Q IY T RRR AE Q
إطرية|Q IY T RRR IY Y AE
إطريفل|Q IY T RRR IY F AE L
إطفائي|Q IY T F AE Q IY Y Y
إعراب|Q IY RH RRR AE B
إعصار|Q IY RH S AE RRR
إعلام|Q IY RH L AE M
إعلامي|Q IY RH L AE M IY Y Y
إعلان|Q IY RH L AE N
إعياء|Q IY RH Y AE Q
إغريقي|Q IY HH RRR IY K IY Y Y
إغليق|Q IY HH L IY K
إغناطيوس|Q IY HH N AE T IY Y UW S
إفادة|Q IY F AE D AE
إفراغ|Q IY F RRR AE HH
إفرند|Q IY F RRR IY N D
إفريقيا|Q IY F RRR IY K Y AE
إفريقية|Q IY F RRR IY K Y AE
إقالة|Q IY K AE L AE
إقامة|Q IY K AE M AE
إقليل|Q IY K L IY L
إقليم|Q IY K L IY M
إقليميا|Q IY K L IY M IY Y AE
إقليمية|Q IY K L IY M IY Y Y AE
إقناع|Q IY K N AE RH
إقنيز|Q IY K N IY Z
إكاف|Q IY K AE F
إكتاب|Q IY K T AE B
إكسينون|Q IY K S IY N OW0 N
إكليل|Q IY K L IY L
إكوادور|Q IY K W AE D OW0 RRR
إل|Q IY L L
إلحاق|Q IY L HH AE K
إلكترونيات|Q IY L IY K T RRR UW N IY Y Y AE T
إله|Q IY L AE HH
إلهام|Q IY L HH AE M
إلى|Q IY L AE
إلياس|Q IY L Y AE S
إما|Q IY M M AE
إمالة|Q IY M AE L AE
إمامة|Q IY M AE M AE
إمبراطوري|Q IY M B AE RRR AE T UW RRR IY Y Y
إمبريالي|Q IY M B IY RRR Y AE L IY Y Y
إمساكية|Q IY M S AE K IY Y Y AE
إمضاء|Q IY M D AE Q
إمكان|Q IY M K AE N
إملاء|Q IY M L AE Q
إمناء|Q IY M N AE Q
إمهال|Q IY M HH AE L
إن|Q IY N N AE
إناء|Q IY N AE Q
إنبيق|Q IY N B IY K
إنتاج|Q IY N T AE D
إنترنت|Q IY N T AE RRR N AE T
إنجلترا|Q IY N G IY L T EH0 RRR AE
إنجليزي|Q IY N G L IY Z IY Y Y
إندونيسي|Q IY N D UW N IY S IY Y Y
إندونيسيا|Q IY N D UW N IY S IY Y AE
إنزكان|Q IY N Z AE G G AE N
إنسان|Q IY N S AE N
إنسانة|Q IY N S AE N AE
إنفحة|Q IY N F AE HH AE
إنقاض|Q IY N K AE D
إنكار|Q IY N K AE RRR
إنكشاري|Q IY N K IY SH AE RRR IY Y Y
إنما|Q IY N N AE M AE
إنموذج|Q IY N M UW DH AE D
إنهاء|Q IY N HH AE Q
إهداء|Q IY HH D AE Q
إهليجي|Q IY HH L IY D IY Y Y
إهليلج|Q IY HH L IY L AE D
إهليلجي|Q IY HH L IY L AE D IY Y Y
إي|Q IY
إيا|Q IY Y Y AE
إياب|Q IY Y AE B
إيارج|Q IY Y AE RRR AE D
إياك|Q IY Y Y AE K IY
إيانا|Q IY Y Y AE N AE
إياهما|Q IY Y Y AE HH UW M AE
إيثار|Q IY TH AE RRR
إيجاد|Q IY D AE D
إيجار|Q IY D AE RRR
إيدز|Q IY D Z
إيذان|Q IY DH AE N
إيران|Q IY RRR AE N
إيريناوس|Q IY RRR IY N AE W UW S
إيصاء|Q IY S AE Q
إيطاليا|Q IY T AE L IY Y AE
إيقاع|Q IY K AE RH
إيمان|Q IY M AE N
ئ|Q
ا|Q UW
ائتلاف|IY Q T IY L AE F
ائتلف|IY Q T AE L AE F AE
ائتلق|IY AE T AE L AE K AE
ائتمر|IY Q T AE M AE RRR AE
ائتنس|IY Q T AE N AE S AE
ابتداء|IY B T IY D AE Q
ابتذل|IY B T AE DH AE L AE
ابتسام|IY B T IY S AE M
ابتسامة|IY B T IY S AE M AE
ابتعد|IY B T AE RH AE D AE
ابتغى|IY B T AE HH AE
ابتل|IY B T AE L L AE
ابتلاش|IY B T IY L AE SH
ابتلال|IY B T IY L AE L
ابتلى|IY B T AE L AE
ابتناء|IY B T IY N AE Q
ابتنى|IY B T AE N AE
ابتهاج|IY B T IY HH AE D
ابتهال|IY B T IY HH AE L
ابتهج|IY B T AE HH AE D AE
ابرغش|IY B RRR AE HH AE SH SH AE
ابن|IY B N IY
ابنة|IY B N AE
ات|AE T
اتبع|IY T T AE B AE RH AE
اتجاه|IY T T IY D AE HH
اتجاهات|IY T T IY D AE HH AE T
اتجه|IY T T AE D AE HH AE
اتحاد|IY T T IY HH AE D
اتحادي|IY T T IY HH AE D IY Y Y
اتحد|IY T T AE HH AE D AE
اتسام|IY T T IY S AE M
اتسع|IY T T AE S AE RH AE
اتسم|IY T T AE S AE M AE
اتصاف|IY T T IY S AE F
اتصال|IY T T IY S AE L
اتصل|IY T T AE S AE L AE
اتضاع|IY T T IY D AE RH
اتضح|IY T T AE D AE HH AE
اتعاظ|IY T T IY RH AE DH
اتعد|IY T T AE RH AE D AE
اتفاق|IY T T IY F AE K
اتهام|IY T T IY HH AE M
اتهم|IY T T AE HH AE M AE
اثنان|IY TH N AE N
اجتاز|IY D T AE Z AE
اجتذب|IY D T AE DH AE B AE
اجتلى|IY D T AE L AE
اجتماع|IY D T IY M AE RH
اجتماعي|IY D T IY M AE RH IY Y Y
اجتنب|IY D T AE N AE B AE
اجتنى|IY D T AE N AE
احتاج|IY HH T AE D AE
احتاز|IY HH T AE Z AE
احتج|IY HH T AE D D AE
احتراق|IY HH T IY RRR AE K
احترف|IY HH T AE RRR AE F AE
احترق|IY HH T AE RRR AE K AE
احتسى|IY HH T AE S AE
احتضن|IY HH T AE D AE N AE
احتفال|IY HH T IY F AE L
احتفل|IY HH T AE F AE L AE
احتقر|IY HH T AE K AE RRR AE
احتكار|IY HH T IY K AE RRR
احتلال|IY HH T IY L AE L
اختار|IY HH T AE RRR AE
اختبأ|IY HH T AE B AE Q
اختبر|IY HH T AE B AE RRR AE
اختتم|IY HH T AE T AE M AE
اخترق|IY HH T AE RRR AE K AE
اختزل|IY HH T AE Z AE L AE
اختص|IY HH T AE S S AE
اختصر|IY HH T AE S AE RRR AE
اختط|IY HH T AE T T AE
اختطاف|IY HH T IY T AE F
اختطف|IY HH T AE T AE F AE
اختل|IY HH T AE L L AE
اختلاس|IY HH T IY L AE S
اختلال|IY HH T IY L AE L
اختلف|IY HH T AE L AE F AE
اختنق|IY HH T AE N AE K AE
ادعى|IY D D AE RH AE
اذلولى|IY DH L AE W L AE
ارتاح|IY RRR T AE HH AE
ارتاع|IY RRR T AE RH AE
ارتباط|IY RRR T IY B AE T
ارتباك|IY RRR T IY B AE K
ارتبط|IY RRR T AE B AE T AE
ارتبك|IY RRR T AE B AE K AE
ارتخى|IY RRR T AE HH AE
ارتدع|IY RRR T AE D AE RH AE
ارتزق|IY RRR T AE Z AE K AE
ارتعش|IY RRR T AE RH AE SH AE
ارتعى|IY RRR T AE RH AE
ارتفع|IY RRR T AE F AE RH AE
ارتقب|IY RRR T AE K AE B AE
ارتياد|IY RRR T IY Y AE D
ارتياع|IY RRR T IY Y AE RH
ازدان|IY Z D AE N AE
ازدحم|IY Z D AE HH AE M AE
ازدهر|IY Z D AE HH AE RRR AE
ازديان|IY Z D IY Y AE N
استأنف|IY S T AE Q N AE F AE
استأهل|IY S T AE Q HH AE L AE
استئمارة|IY S T IY Q M AE RRR AE
استبحر|IY S T AE B HH AE RRR AE
استبد|IY S T AE B AE D D AE
استثمار|IY S T IY TH M AE RRR
استثناء|IY S T IY TH N AE Q
استثنائي|IY S T IY TH N AE Q IY Y Y
استجاب|IY S T AE D AE B AE
استجار|IY S T AE D AE RRR AE
استجمام|IY S T IY D M AE M
استجهل|IY S T AE D HH AE L AE
استحال|IY S T AE HH AE L AE
استحصل|IY S T AE HH S AE L AE
استحضر|IY S T AE HH D AE RRR AE
استحم|IY S T AE HH AE M M AE
استحوذ|IY S T AE HH W AE DH AE
استحيا|IY S T AE HH Y AE
استخبار|IY S T IY HH B AE RRR
استخدم|IY S T AE HH D AE M AE
استخرج|IY S T AE HH RRR AE D AE
استدعاء|IY S T IY D RH AE Q
استدعى|IY S T AE D RH AE
استدل|IY S T AE D AE L L AE
استرجع|IY S T AE RRR D AE RH AE
استرخاء|IY S T IY RRR HH AE Q
استسلم|IY S T AE S L AE M AE
استشار|IY S T AE SH AE RRR AE
استشراق|IY S T IY SH RRR AE K
استشرق|IY S T AE SH RRR AE K AE
استصبر|IY S T AE S B AE RRR AE
استصح|IY S T AE S AE HH HH AE
استصرخ|IY S T AE S RRR AE HH AE
استضاف|IY S T AE D AE F AE
استطار|IY S T AE T AE RRR AE
استطرد|IY S T AE T RRR AE D AE
استعاذ|IY S T AE RH AE DH AE
استعارة|IY S T IY RH AE RRR AE
استعان|IY S T AE RH AE N AE
استعصم|IY S T AE RH S AE M AE
استعمار|IY S T IY RH M AE RRR
استعمر|IY S T AE RH M AE RRR AE
استعمل|IY S T AE RH M AE L AE
استغاث|IY S T AE HH AE TH AE
استغرق|IY S T AE HH RRR AE K AE
استغفر|IY S T AE HH F AE RRR AE
استغل|IY S T AE HH AE L L AE
استغنى|IY S T AE HH N AE
استفاق|IY S T AE F AE K AE
استفتاء|IY S T IY F T AE Q
استفتى|IY S T AE F T AE
استفراغ|IY S T IY F RRR AE HH
استفرغ|IY S T AE F RRR AE HH AE
استفز|IY S T AE F AE Z Z AE
استفزاز|IY S T IY F Z AE Z
استفسار|IY S T IY F S AE RRR
استفهام|IY S T IY F HH AE M
استفهامي|IY S T IY F HH AE M IY Y Y
استقبال|S T IY K B AE L
استقتل|IY S T AE K T AE L AE
استقدم|IY S T AE K D AE M AE
استقل|IY S T AE K AE L L AE
استقلال|IY S T IY K L AE L
استكرى|IY S T AE K RRR AE
استكشاف|IY S T IY K SH AE F
استل|IY S T AE L L AE
استلزم|IY S T AE L Z AE M AE
استمات|IY S T AE M AE T AE
استمارة|IY S T IY M AE RRR AE
استمتع|IY S T AE M T AE RH AE
استمد|IY S T AE M AE D D AE
استمر|IY S T AE M AE RRR RRR AE
استمرار|IY S T IY M RRR AE RRR
استمسك|IY S T AE M S AE K AE
استمنى|IY S T AE M N AE
استنتاج|IY S T IY N T AE D
استنشق|IY S T AE N SH AE K AE
استنفاد|IY S T IY N F AE D
استنفد|IY S T AE N F AE D AE
استنكر|IY S T AE N K AE RRR AE
استهجان|IY S T IY HH D AE N
استهجن|IY S T AE HH D AE N AE
استهلك|IY S T AE HH L AE K AE
استهوى|IY S T AE HH W AE
استودع|IY S T AE W D AE RH AE
استوضح|IY S T AE W D AE HH AE
استوطأ|IY S T AE W T AE Q AE
استوعب|IY S T AE W RH AE B AE
استوقف|IY S T AE W K AE F AE
استيعاب|IY S T IY RH AE B
استيقظ|IY S T AE Y K AE DH AE
اسكتلندي|IY S K UW T L AE N D IY Y Y
اسم|UW S M UW
اشتاق|IY SH T AE K AE
اشتباك|IY SH T IY B AE K
اشتباه|IY SH T IY B AE HH
اشتد|IY SH T AE D D AE
اشترط|IY SH T AE RRR AE T AE
اشترى|IY SH T AE RRR AE
اشتق|IY SH T AE K K AE
اشتهى|IY SH T AE HH AE
اشتياق|IY SH T IY Y AE K
اشهل|IY SH HH AE L L AE
اشهلال|IY SH HH IY L AE L
اصباح|IY S B AE HH HH AE
اصحام|IY S HH AE M M AE
اصطاد|IY S T AE D AE
اصطب|IY S T AE B B AE
اصطباغ|IY S T IY B AE HH
اصطبغ|IY S T AE B AE HH AE
اصطبن|IY S T AE B AE N AE
اصطخد|IY S T AE HH AE D AE
اصطخم|IY S T AE HH AE M AE
اصطدأ|IY S T AE D AE Q AE
اصطك|IY S T AE K K AE
اصطلاح|IY S T IY L AE HH
اصطلح|IY S T AE L AE HH AE
اصطناعي|IY S T IY N AE RH IY Y Y
اصهاب|IY S HH AE B B AE
اصهب|IY S HH AE B B AE
اضطر|IY D T AE RRR RRR AE
اضطراب|IY D T IY RRR AE B
اضطرب|IY D T AE RRR AE B AE
اضطهاد|IY D T IY HH AE D
اطرد|UW T RRR UW D
اطمأننا|Q IY T M AE Q N AE N N AE
اعتاد|IY RH T AE D AE
اعتاض|IY RH T AE D AE
اعتبر|IY RH T AE B AE RRR AE
اعتداء|IY RH T IY D AE Q
اعتدال|IY RH T IY D AE L
اعتدى|IY RH T AE D AE
اعتذر|Q AE RH T AE DH IY RRR
اعتزام|IY RH T IY Z AE M
اعتزل|IY RH T AE Z AE L AE
اعتصم|IY RH T AE S AE M AE
اعتقاد|IY RH T IY K AE D
اعتقادية|IY RH T IY K AE D IY Y Y AE
اعتقد|IY RH T AE K AE D AE
اعتقل|IY RH T AE K AE L AE
اعتل|IY RH T AE L L AE
اعتلى|IY RH T AE L AE
اعتمد|IY RH T AE M AE D AE
اعتنى|IY RH T AE N AE
اعوج|IY RH W AE D D AE
اغتاب|IY HH T AE B AE
اغتصب|IY HH T AE S AE B AE
اغتنم|IY HH T AE N AE M AE
اغرورق|IY HH RRR AE W RRR AE K AE
افتخر|IY F T AE HH AE RRR AE
افتراع|IY F T IY RRR AE RH
افترض|IY F T AE RRR AE D AE
افترق|IY F T AE RRR AE K AE
افترى|IY F T AE RRR AE
افتقد|IY F T AE K AE D AE
اقتاد|IY K T AE D AE
اقتحم|IY K T AE HH AE M AE
اقترب|IY K T AE RRR AE B AE
اقترح|IY K T AE RRR AE HH AE
اقتسم|IY K T AE S AE M AE
اقتصاد|IY K T IY S AE D
اقتصد|IY K T AE S AE D AE
اقتصر|IY K T AE S AE RRR AE
اقتضى|IY K T AE D AE
اقتطف|K AE T AE F AE
اقتعد|IY K T AE RH AE D AE
اقشعر|IY K SH AE RH AE RRR RRR AE
اكتئاب|IY K T IY Q AE B
اكتتاب|IY K T IY T AE B
اكتتب|IY K T AE T AE B AE
اكتحل|IY K T AE HH AE L AE
اكترى|IY K T AE RRR AE
اكتسب|IY K T AE S AE B AE
اكتسى|IY K T AE S AE
اكتظ|IY K T AE DH DH AE
اكتظاظ|IY K T IY DH AE DH
اكتفاء|IY K T IY F AE Q
اكتفى|IY K T AE F AE
اكتنف|IY K T AE N AE F AE
الآخرة|AE L Q AE HH IY RRR AE
الآن|AE L Q AE N AE
الأحد|AE L Q AE HH AE D
الأربعاء|AE L Q AE RRR B IY RH AE Q
الأرثوذكسية|AE L Q UW RRR TH UW DH UW K S IY Y Y AE
الأرجنتين|AE L Q AE RRR D AE N T IY N
الأردن|AE L Q UW RRR D UW N N
الأرض|AE L Q AE RRR D
الأشهل|AE L Q AE SH HH AE L
الألى|AE L Q UW L AE
الأندلس|AE L Q AE N D UW L UW S
الإسكندرية|AE L Q IY S K AE N D AE RRR IY Y Y AE
الإسلام|AE L Q IY S L AE M
الإمارات|AE L Q IY M AE RRR AE T
الإنجيل|AE L Q IY N D IY L
الاثنين|AE L IY TH N AE Y N
البحرين|AE L B AE HH RRR AE Y N
البرازيل|AE L B AE RRR AE Z IY L
البراق|AE L B UW RRR AE K
البرتغال|AE L B UW RRR T UW HH AE L
البرجيس|AE L B IY RRR D IY S
البندقية|AE L B UW N D UW K IY Y Y AE
البهاما|AE L B AE HH AE M AE
التباس|IY L T IY B AE S
التحق|IY L T AE HH AE K AE
التشيك|AE T T SH IY K
التصق|IY L T AE S AE K AE
التقط|IY L T AE K AE T AE
التهاب|IY L T IY HH AE B
التهب|IY L T AE HH AE B AE
التهم|IY L T AE HH AE M AE
الثلاثاء|AE TH TH UW L AE TH AE Q
الجديدة|AE L D AE D IY D AE
الجزائر|AE L D AE Z AE Q IY RRR
الجمعة|AE L D UW M RH AE
الحارث|AE L HH AE RRR IY TH
الحبش|AE L HH AE B AE SH
الحبشة|AE L HH AE B AE SH AE
الحسيمة|AE L HH UW S AE Y M AE
الخرطوم|AE L HH UW RRR T UW M
الخمس|AE L HH UW M S
الخميس|AE L HH AE M IY S
الخميسات|AE L HH UW M AE Y S AE T
الدانوب|AE D D AE N UW B
الدنمارك|AE D D AE N M AE RRR K
الدوحة|AE D D AE W HH AE
الذي|AE L L AE DH IY
الرباط|AE RRR RRR IY B AE T
الرياض|AE RRR RRR IY Y AE D
الزرقاء|AE Z Z AE RRR K AE Q
الزهرة|AE Z Z UW HH AE RRR AE
السبت|AE S S AE B T
السعودية|AE S S UW RH UW D IY Y Y AE
السفن|AE S S UW F UW N
السلفادور|AE S S AE L F AE D UW RRR
السنغال|AE S S IY N IY HH AE L
السودان|AE S S UW D AE N
السويد|AE S S UW W AE Y D
الصربية|AE S S IY RRR B IY Y Y AE
الصومال|AE S S UW M AE L
الصويرة|AE S S AE W IY RRR AE
الصين|AE S S IY N
العاصي|AE L RH AE S IY
العبرية|AE L RH IY B RRR IY Y Y AE
العرائش|AE L RH AE RRR AE Q IY SH
العراق|AE L RH IY RRR AE K
العزى|AE L RH UW Z Z AE
الغابون|AE L HH AE B UW N
الفاتيكان|AE L V AE T IY K AE N
الفاطر|AE L F AE T IY RRR
الفرات|AE L F UW RRR AE T
الفصحى|AE L F UW S HH AE
الفلبين|AE L F IY L IY B B IY N
القاهرة|AE L K AE HH IY RRR AE
القدس|AE L K UW D S
القرآن|AE L K UW RRR Q AE N
القسطنطينية|AE L K UW S T AE N T IY N IY Y Y AE
القطيف|IH L K AH0 T IY F
القنيطرة|AE L K UW N AE Y T IY RRR AE
الكاميرون|AE L K AE M IY RRR UW N
الكنية|AE L K UW N Y AE
الكويت|AE L K UW W AE Y T
اللات|AE L L AE T
الله|AE L L AE HH UW
اللهم|Q AE L L AE HH UW M M AE
المجر|AE L M AE D AE RRR
المحمدية|AE L M UW HH AE M M AE D IY Y Y AE
المرء|AE L M AE RRR Q
المريخ|AE L M IY RRR RRR IY HH
المسيح|AE L M AE S IY HH
المشتري|AE L M UW SH T AE RRR IY
المغرب|AE L M AE HH RRR IY B
المكسيك|AE L M AE K S IY K
المنامة|AE L M AE N AE M AE
الناظور|AE N N AE DH UW RRR
النرويج|AE N N UW RRR W IY D
النمسا|AE N N IY M S AE
النيجر|AE N N IY D AE RRR
الهند|AE L HH IY N D
الوداع|AE L W AE D AE RH
اليابان|AE L Y AE B AE N
اليرموك|AE L Y AE RRR M UW K
اليسع|AE L Y AE S AE RH
اليمن|AE L Y AE M AE N
اليوم|AE L Y AE W M AE
اليونان|AE L Y UW N AE N
امتحان|IY M T IY HH AE N
امتعاض|IY M T IY RH AE D
امتعض|IY M T AE RH AE D AE
امتن|IY M T AE N N AE
امتنع|IY M T AE N AE RH AE
امرأ|IY M RRR AE Q AE N
امرأة|IY M RRR AE Q AE
امرؤ|IY M RRR UW Q
امناء|Q IY M N AE Q
انبث|IY N B AE TH TH AE
انبثق|IY N B AE TH AE K AE
انبغى|IY N B AE HH AE
انتبه|IY N T AE B AE HH AE
انتحال|IY N T IY HH AE L
انتحب|IY N T AE HH AE B AE
انتخب|IY N T AE HH AE B AE
انتزع|IY N T AE Z AE RH AE
انتشار|IY N T IY SH AE RRR
انتشق|IY N T AE SH AE K AE
انتصار|IY N T IY S AE RRR
انتصب|IY N T AE S AE B AE
انتظام|IY N T IY DH AE M
انتظر|IY N T AE DH AE RRR AE
انتظم|IY N T AE DH AE M AE
انتفاضة|IY N T IY F AE D AE
انتفخ|IY N T AE F AE HH AE
انتقاض|IY N T IY K AE D
انتقال|IY N T IY K AE L
انتقام|IY N T IY K AE M
انتقد|IY N T AE K AE D AE
انتقض|IY N T AE K AE D AE
انتقل|IY N T AE K AE L AE
انتقم|IY N T AE K AE M AE
انتماء|IY N T IY M AE Q
انتمى|IY N T AE M AE
انتهاك|IY N T IY HH AE K
انتهك|IY N T AE HH AE K AE
انتهى|IY N T AE HH AE
انجذاب|IY N D IY DH AE B
انجراف|IY N D IY RRR AE F
انجرف|IY N D AE RRR AE F AE
انحاز|IY N HH AE Z AE
انخرط|IY N HH AE RRR AE T AE
انخفاض|IY N HH IY F AE D
انخفض|IY N HH AE F AE D AE
اندفاع|IY N D IY F AE RH
اندلع|IY N D AE L AE RH AE
اندمج|IY N D AE M AE D AE
اندمل|IY N D AE M AE L AE
انزعاج|IY N Z IY RH AE D
انسجام|IY N S IY D AE M
انسحب|IY N S AE HH AE B AE
انسحق|IY N S AE HH AE K AE
انسل|IY N S AE L L AE
انسلخ|IY N S AE L AE HH AE
انشق|IY N SH AE K K AE
انشقاق|IY N SH IY K AE K
انصبن|IY N S AE B AE N AE
انصرف|IY N S AE RRR AE F AE
انضم|IY N D AE M M AE
انطبق|IY N T AE B AE K AE
انطلق|IY N T AE L AE K AE
انعدى|IY N RH AE D AE
انعقاد|IY N RH IY K AE D
انفتح|IY N F AE T AE HH AE
انفرث|IY N F AE RRR AE TH AE
انفرط|IY N F AE RRR AE T AE
انقد|IY N K AE D D AE
انقراض|IY N K IY RRR AE D
انقرض|IY N K AE RRR AE D AE
انقشع|Q IY N K AE SH AE RH AE
انقضاض|IY N K IY D AE D
انقضى|IY N K AE D AE
انقطع|IY N K AE T AE RH AE
انقلاب|IY N K IY L AE B
انقلب|IY N K AE L AE B AE
انكتاب|IY N K IY T AE B
انكتب|IY N K AE T AE B AE
انكمش|IY N K AE M AE SH AE
انهار|IY N HH AE RRR AE
انهمر|IY N HH AE M AE RRR AE
انهمك|IY N HH AE M AE K AE
اهتدى|IY HH T AE D AE
اهتز|IY HH T AE Z Z AE
اهتم|IY HH T AE M M AE
اِ|Q IY
ب|B IY
بأس|B AE Q S
بؤر|B UW Q AE RRR
بؤرة|B UW Q RRR AE
بئر|B IY Q RRR
بئس|B AE Q IY S AE
بئسما|B IY Q S AE M AE
باء|B AE Q AE
بائس|B AE Q IY S
بائع|B AE Q IY RH
بائن|B AE Q IY N
باب|B AE B
بابا|B AE B AE
بابل|B AE B IY L
بابور|B AE B UW RRR
بابونج|B AE B UW N AE D
باح|B AE HH AE
باحث|B AE HH IY TH
باخوم|B AE HH UW M
باد|B AE D IY N
بادية|B AE D IY Y AE
باذنجان|B AE DH IY N D AE N
باراغواي|B AE RRR AE HH UW W AE Y
بارد|B AE RRR IY D
بارز|B AE RRR IY Z
بارزد|B AE RRR Z AE D
بارزذ|B AE RRR Z AE DH
بارك|B AE RRR AE K AE
باروق|B AE RRR UW K
باريس|B AE RRR IY S
باز|B AE Z
بازار|B AE Z AE RRR
بازنقر|B AE Z IY N G IY RRR
بازهر|B AE Z AE HH RRR
باستا|P AE S T AE
باسل|B AE S IY L
باسور|B AE S UW RRR
باص|B AE S
باصور|B AE S UW RRR
باضع|B AE D IY RH
باطس|B AE T UW S
باطني|B AE T IY N IY Y Y
باطية|B AE T IY Y AE
باع|B AE RH AE
باغت|B AE HH AE T AE
باقة|B AE K AE
باقلاء|B AE K IY L L AE Q
باقلى|B AE K IY L L AE
باكستان|B AE K IY S T AE N
باكستاني|B AE K IY S T AE N IY Y Y
باكو|B AE K UW
بال|B L
بالة|B AE L AE
بالتوفيق|B IY T T AE W F IY K IY
بالضبط|B IY D D AE B T IY
بالعكس|B IY L RH AE K S
بالفعل|B IY L F IY RH L IY
بالوعات|B AE L UW RH AE T
بالون|B AE L UW N
باليه|B AE L EH0 HH
بامية|B AE M IY Y AE
ببر|B AE B RRR
ببنودة|B AE B N UW D AE
بتاتا|B AE T AE T AE
بتة|B AE T T AE
بتع|B IY T RH
بتليس|B IY T L IY S
بتول|B AE T UW L
بتولية|B AE T UW L IY Y Y AE
بثرات|B AE TH AE RRR AE T
بثن|B AE TH AE N
بثور|B UW TH UW RRR
بجد|B IY D IY D D IY N
بجوار|B IY D IY W AE RRR
بح|B AE HH HH AE
بحاح|B UW HH AE HH
بحار|B AE HH HH AE RRR
بحث|B AE HH TH
بحر|B AE HH HH AE RRR AE
بحران|B UW HH RRR AE N
بحري|B AE HH RRR IY Y Y
بحريني|B AE HH RRR AE Y N IY Y Y
بحيرة|B UW HH AE Y RRR AE
بخت|B UW HH T
بخشيش|B AE HH SH IY SH
بخص|B AE HH AE S AE
بخير|B IY HH AE Y RRR
بدأ|B AE D AE Q AE
بدا|B AE D AE
بدر|B AE D RRR
بدلات|B AE D AE L AE T
بدلة|B AE D L AE
بدليس|B AE D L IY S
بدنة|B AE D AE N AE
بدني|B AE D AE N IY Y Y
بدهي|B AE D AE HH IY Y Y
بدوي|B AE D AE W IY Y Y
بديهي|B AE D IY HH IY Y Y
بذ|B AE DH DH AE
بذاءة|B AE DH AE Q AE
بذج|B UW DH AE D
بذرقطونا|B AE DH RRR AE K AE T UW N AE
بذلة|B IY DH L AE
برأ|B AE RRR AE Q AE
برئ|B AE RRR IY Q AE
براءة|B AE RRR AE Q AE
براشوت|B AE RRR AE SH UW T
براعة|B AE RRR AE RH AE
براغ|B RRR AE HH
براق|B AE RRR RRR AE K
براني|B AE RRR RRR AE N IY Y Y
براين|B RRR AE Y AE N
بربارة|B AE RRR B AE RRR AE
برباريس|B AE RRR B AE RRR IY S
بربخ|B AE RRR B AE HH
بربري|B AE RRR B AE RRR IY Y Y
بربرية|B AE RRR B AE RRR IY Y Y AE
بربير|B AE RRR B IY RRR
برتقال|B UH RRR T AH0 K AA L
برتقالي|B UW RRR T UW K AE L IY Y Y
برج|B UW RRR D
برجار|B IY RRR D AE RRR
برجل|B AE RRR D AE L
برح|B AE RRR RRR AE HH AE
بردعة|B AE RRR D AE RH AE
بردقوش|B AE RRR D AE K UW SH
بردي|B UW RRR D IY Y Y
برذعة|B AE RRR DH AE RH AE
برذون|B IY RRR DH AE W N
برر|B AE RRR RRR AE RRR AE
برز|B AE RRR AE Z AE
برسيم|B IY RRR S IY M
برشام|B UW RRR SH AE M
برشومي|B AE RRR SH UW M IY Y Y
برشيد|B AE RRR SH IY D
برعم|B UW RRR RH UW M
برغش|B AE RRR HH AE SH
برغوث|B UW RRR HH UW TH
برغي|B UW RRR HH IY Y Y
برق|B AE RRR K
برقوق|B UW RRR K UW K
برقية|B AE RRR K IY Y Y AE
بركار|B IY RRR K AE RRR
بركان|B UH RRR K AE N
بركة|B UW RRR K AE
بركري|B AE RRR K AE RRR IY Y Y
برلمان|B AE RRR L AE M AE N
برمائي|B AE RRR M AE Q IY Y Y
برمج|B AE RRR M AE D AE
برن|B UW RRR N AE
برنامج|B AE RRR N AE M AE D
برنية|B AE RRR N IY Y Y AE
برنيق|B IY RRR N IY K
برهة|B UW RRR HH AE
برواز|B AE RRR W AE Z
بروكسل|B RRR UW K S IY L
بروناي|B RRR UW N AE Y
بري|B AE RRR RRR IY
بريد|B AE RRR IY D
بريطاني|B IY RRR IY T AE N IY Y Y
بريمة|B AE RRR RRR IY M AE
بزاز|B AE Z Z AE Z
بزاق|B UW Z AE K
بزاقة|B AE Z Z AE K AE
بزرقطونا|B AE Z RRR AE K AE T UW N AE
بزق|B AE Z K
بزم|B AE Z AE M AE
بس|B AE S S AE
بساط|Q AE B S IY T AE
بساطة|B AE S AE T AE
بسالة|B AE S AE L AE
بسباس|B IY S B AE S
بسباسة|B IY S B AE S AE
بسبايج|B AE S B AE Y AE D
بسبب|B IY S AE B AE B IY
بستان|B UW S T AE N
بستو|P EH0 S T OW0
بستوقة|B UW S T UW K AE
بسفايج|B AE S F AE Y AE D
بسكرة|B IY S K AE RRR AE
بسمة|B AE S M AE
بسملة|B AE S M AE L AE
بشار|B IY SH AE RRR
بشرة|B AE SH AE RRR AE
بشري|B AE SH AE RRR IY Y Y
بشرية|B AE SH AE RRR IY Y Y AE
بشع|B AE SH IY RH
بشملة|B AE SH M AE L AE
بشندي|B AE SH AE N D IY
بشنونة|B AE SH N UW N AE
بشوش|B AE SH UW SH
بصق|B AE S K
بصل|B AE S AE L
بصير|B AE S IY RRR
بضاعة|B IY D AE RH AE
بضع|B IY D RH
بضعة|B IY D RH AE
بطء|B UW T Q
بطؤ|B AE T UW Q AE
بطاء|B IY T AE Q
بطارخ|B UW T AE RRR IY HH
بطارقة|B AE T AE RRR IY K AE
بطاريق|B AE T AE RRR IY K
بطاطا|B AE T AE T AE
بطاطس|B AE T AE T IY S
بطاقة|B IY T AE K AE
بطالة|B IY T AE L AE
بطانة|B IY T AE N AE
بطة|B AE T T AE
بطرخ|B AE T RRR AE HH
بطرس|B UW T RRR UW S
بطرك|B AE T RRR AE K
بطروخ|B AE T RRR UW HH
بطريركية|B AE T RRR IY Y AE RRR K IY Y Y AE
بطريك|B AE T RRR IY K
بطم|B UW T M
بطن|B AE T T AE N AE
بطولة|B UW T UW L AE
بطيء|B AE T IY Q
بظر|B AA DH RRR
بعث|B AE RH TH
بعثة|B AE RH TH AE
بعثران|B AE RH TH AE RRR AE N
بعثي|B AE RH TH IY Y Y
بعدما|B AE RH D AE M AE
بعر|B AE RH RRR
بعض|B AE RH D
بعل|B AE RH L
بعلبك|B RH AE L B AE K
بعلة|B AE RH L AE
بعوض|B AE RH UW D
بعيثران|B UW RH AE Y TH AE RRR AE N
بعيد|B AE RH IY D
بعير|B AE RH IY RRR
بغاء|B IY HH AE Q
بغتة|B AE HH T AE
بغداد|B AE HH D AE D
بغرير|B AE HH RRR IY RRR
بغل|B AE HH L
بغلة|B AE HH L AE
بغي|B AE HH IY Y Y
بغية|B UW HH Y AE
بغيض|B AE HH IY D
بقاع|B IY K AE RH
بقبق|B AE K B AE K AE
بقجة|B UW K D AE
بقدونس|B AE K D UW N IY S
بقر|B AE K AE RRR
بقرة|B AE K AE RRR AE
بقس|B UW K S
بقشة|B UW K SH AE
بقص|B UW K S
بقع|B UW K AE RH
بقعة|B UW K RH AE
بقل|B AE K L
بقي|B IY G IY
بقية|B AE K IY Y Y AE
بكارة|B AE K AE RRR AE
بكارج|B AE K AE RRR IY D
بكة|B AE K K AE
بكتيريا|B AE K T IY RRR IY Y AE
بكرج|B AE K RRR AE D
بكى|B UW K AE N
بكين|P IY K IY N
بلادونا|B IY L AE D UW N AE
بلاذر|B AE L AE DH UW RRR
بلاستيك|B L AE S T IY K
بلاستيكي|B L AE S T IY K IY Y Y
بلاعة|B AE L L AE RH AE
بلاغة|B AE L AE HH AE
بلان|B AE L L AE N
بلاهة|B AE L AE HH AE
بلجيكا|B IY L ZH IY K AE
بلجيكي|B IY L D IY K IY Y Y
بلس|B UW L UW S
بلشون|B AE L AE SH UW N
بلطة|B AE L T AE
بلطي|B UW L T IY Y Y
بلعوم|B UW L RH UW M
بلغاري|B UW L HH AE RRR IY Y Y
بلغاريا|B UW L HH AE RRR IY Y AE
بلغم|B AE L HH AE M
بلغمي|B AE L HH AE M IY Y Y
بلكفة|B AE L K AE F AE
بلل|B AE L L AE L AE
بلوة|B IY L W AE
بلوتو|B L UW T UW
بلور|B IY L L UW RRR
بلوط|B AE L L UW T
بليج|B IY L L IY D
بليحا|B AE L IY HH AE
بليحاء|B AE L IY HH AE Q
بليحة|B AE L IY HH AE
بليز|B AE L IY Z
بليلة|B AE L IY L AE
بليلج|B AE L IY L AE D
بن|IY B N
بنان|B AE N AE N
بناية|B IY N AE Y AE
بنت|B IY N T UW
بنجر|B AE N D AE RRR
بنجنكشت|B AE N D AE N K UW SH T
بند|B AE N D
بندر|B AE N D AE RRR
بندق|B UW N D UW G
بندقاني|B UW N D UW K AE N IY
بنطال|B AE N T AE L
بنغلاديش|B AE N HH L AE D EH0 SH
بنفسج|B AE N AE F S AE D
بنفسجي|B AE N AE F S AE D IY Y Y
بنك|B AE N K
بنما|B AE N AE M AE
بنين|B IY N IY N
بهاء|B AE HH AE Q
بهائي|B AE HH AE Q IY Y Y
بهار|B UW HH AE RRR
بهر|B AE HH AE RRR AE
بهرج|B AE HH RRR AE D
بهشية|B AE HH AE SH IY Y Y AE
بهلول|B UW HH L UW L
بهمن|B AE HH M AE N
بهيج|B AE HH IY D
بهيجة|B AE HH IY D AE
بهيم|B AE HH IY M
بهيمة|B AE HH IY M AE
بواب|B AE W W AE B
بوابة|B AE W W AE B AE
بواليع|B AE W AE L IY RH
بوان|B IY W AE N
بوتاسيوم|B UW T AE S IY Y UW M
بوتان|B UW T AE N
بوخارست|B UW HH AE RRR EH0 S T
بودابست|B UW D AE B IY S T
بوذا|B UW DH AE
بوذي|B UW DH IY Y Y
بوذية|B UW DH IY Y Y AE
بورتسودان|B UW RRR T S UW D AE N
بورسودان|B UW RRR S UW D AE N
بورصة|B UW RRR S AE
بورما|B UW RRR M AE
بورندي|B UW RRR UW N D IY
بوروندي|B UW RRR UW N D IY
بوري|B UW RRR IY
بوسة|B UW S AE
بوسكورة|B UW S K UW RRR AE
بوصلة|B UW S UW L AE
بوصير|B UW S IY RRR
بوط|B UW T
بولاد|B UW L AE D
بولس|B UW L UW S
بولندا|P OW0 L AE N D AE
بوليس|B UW L IY S
بوليفيا|B UW L IY F IY Y AE
بيئة|B IY Q AE
بيت|B IY T AE
بيد|B AE Y D AE
بيداء|B AE Y D AE Q
بيدر|B AE Y D AE RRR
بيدق|B AE Y D AE K
بيرق|B AE Y RRR AE K
بيرو|B EH0 RRR UW
بيروت|B AE Y RRR UW T
بيروقراطي|B IY RRR UW K RRR AE T IY Y Y
بيسوس|B AE Y S UW S
بيش|B IY SH
بيض|B IY D
بيطرة|B AE Y T AE RRR AE
بيع|B AE Y RH
بيعة|B IY RH AE
بيفام|B IY F AE M
بيقية|B IY K IY Y Y AE
بيلادونا|B IY L AE D UW N AE
بيلاروسي|B IY L AE RRR UW S IY Y Y
بيلاروسيا|B EH0 L AE RRR UW S Y AE
بيلقان|B AE Y L AE K AE N
بين|B AE Y N AE
بينما|B AE Y N AE M AE
بينيت|B IY N IY T
بينيث|B IY N IY TH
بيوت|B UW Y UW T
ة|RRR
ت|T AE Q
تأثير|T AE Q TH IY RRR
تأخير|T AE Q HH IY RRR
تأرجح|T AE Q AE RRR D AE HH AE
تأسف|T AE Q AE S S AE F AE
تأكيد|T AE Q K IY D
تألف|T AE Q AE L L AE F AE
تألق|T AE Q AE L L UW K
تأمرك|T AE Q AE M RRR AE K AE
تأمور|T AE Q M UW RRR
تأموري|T AE Q M UW RRR IY Y Y
تأميم|T AE Q M IY M
تأنجل|T AE Q AE N G AE L AE
تأنق|T AE Q AE N N AE K AE
تأوه|T AE Q AE W W UW HH
تاء|T AE Q
تاب|T AE B AE
تابوت|T AE B UW T
تاج|T AE D
تاجر|T AE D IY RRR
تاجورة|T AE D UW RRR AE
تارة|T AE RRR AE
تاريخ|T AE RRR IY HH
تاريخية|T AE RRR IY HH IY Y Y AE
تازة|T AE Z AE
تاسع|T AE S IY RH
تافه|T AE F IY HH
تاق|T AE K AE
تاكسي|T AE K S IY
تال|T AE L IY N
تالله|T AE L L AE HH IY
تالي|T AE L IY
تامول|T AE M UW L
تانبول|T AE N AE B UW L
تاوريرت|T AE W RRR IY RRR T
تايلاند|T AE Y L AE N D
تايلند|T AE Y L AE N D
تايلندي|T AE Y L AE N D IY Y Y
تايوان|T AE Y W AE N
تب|T AE B B AE
تبارى|T AE B AE RRR AE
تباطأ|T AE B AE T AE Q AE
تباكى|T AE B AE K AE
تباهى|T AE B AE HH AE
تبحر|T AE B AE HH HH AE RRR AE
تبرع|T AE B AE RRR RRR AE RH AE
تبرم|T AE B AE RRR RRR AE M AE
تبرير|T AE B RRR IY RRR
تبريز|T AE B RRR IY Z
تبشير|T AE B SH IY RRR
تبعية|T AE B AE RH IY Y Y AE
تبغ|T IY B HH
تترى|T AE T RRR AE
تتلى|T UW T L AE
تتويج|T AE T W IY D
تجادل|T AE D AE D AE L AE
تجارة|T IY D AE RRR AE
تجاري|T IY D AE RRR IY Y Y
تجاوزات|T AE D AE W UW Z AE T
تجدد|T AE D AE D D UW D
تجذير|T AE D DH IY RRR
تجربة|T AE D RRR IY B AE
تجرد|T AE D AE RRR RRR UW D
تجرع|T AE D AE RRR RRR AE RH AE
تجريف|T AE D RRR IY F
تجنب|T AE D AE N N UW B
تجنى|T AE D AE N N AE
تجوف|T AE D AE W W UW F
تحاشى|T AE HH AE SH AE
تحالف|T AE HH AE L UW F
تحت|T AE HH T UW
تحدى|T AE HH AE D D AE
تحذير|T AE HH DH IY RRR
تحرش|T UW HH RRR AE SH UW
تحرك|T AE HH AE RRR RRR AE K AE
تحرير|T AE HH RRR IY RRR
تحريض|T AE HH RRR IY D
تحريضي|T AE HH RRR IY D IY Y Y
تحسس|T AE HH AE S S AE S AE
تحفة|T UW HH F AE
تحكم|T AE HH AE K K UW M
تحكيم|T AE HH K IY M
تحليلي|T AE HH L IY L IY Y Y
تحمس|T AE HH AE M M UW S
تحمم|T AE HH AE M M AE M AE
تحوز|T AE HH AE W W AE Z AE
تحوط|T AE HH AE W W UW T
تحولة|T AE HH W IY L AE
تحويط|T AE HH W IY T
تحيز|T AE HH AE W W AE Z AE
تخت|T AE HH T
تختج|T AE HH T AE D
تخدر|T AE HH AE D D AE RRR AE
تخدير|T AE HH D IY RRR
تخضخض|T AE HH AE D HH AE D AE
تخطى|T AE HH AE T T AE
تخفيض|T AE HH F IY D
تخفيف|T AE HH F IY F
تخلص|T AE HH AE L L UW S
تخم|T UW HH M
تداع|T AE D AE RH IY N
تداعى|T AE D AE RH AE
تدثر|T AE D AE TH TH AE RRR AE
تدخين|T AE D HH IY N
تدرب|T AE D AE RRR RRR UW B
تدربس|T AE D AE RRR B AE S AE
تدرج|T AE D RRR UW D
تدريب|T AE D RRR IY B
تدريج|T AE D RRR IY D
تدريجي|T AE D RRR IY D IY Y Y
تدريس|T AE D RRR IY S
تدلى|T AE D AE L L AE
تدليك|T AE D L IY K
تدليل|T AE D L IY L
تدمير|T AE D M IY RRR
تدهور|T AE D AE HH W UW RRR
تدوير|T AE D W IY RRR
تذاكى|T AE DH AE K AE
تذبذب|T AE DH AE B DH UW B
تذكار|T IY DH K AE RRR
تذكر|T AE DH AE K K UW RRR
تذكرة|T AE DH K IY RRR AE
تذمر|T AE DH AE M M UW RRR
تراب|T UW RRR AE B
تراجم|T AE RRR AE D IY M
تراجيديا|T RRR AE D IY D Y AE
تراخوما|T IY RRR AE HH UW M AE
ترانزستور|T RRR AE N Z IY S T UW RRR
تراوح|T AE RRR AE W UW HH
تربة|T UW RRR B AE
تربية|T AE RRR B IY Y AE
ترجم|T AE RRR D AE M AE
ترجمة|T AE RRR D AE M AE
ترجى|T AE RRR AE D D AE
ترسانة|T IY RRR S AE N AE
ترسة|T IY RRR S AE
ترصد|T AE RRR AE S S AE D AE
ترعة|T UW RRR RH AE
ترعرع|T AE RRR AE RH RRR AE RH AE
ترفع|T AE RRR AE F F UW RH
ترقوة|T AE RRR K UW W AE
ترك|T UW RRR K
تركاش|T AE RRR K AE SH
تركمانستان|T UW RRR K UW M AE N IY S T AE N
تركيا|T UW RRR K IY Y Y AE
تركيب|T AE RRR K IY B
ترمس|T UW RRR M UW S
ترميم|T AE RRR M IY M
ترنج|T UW RRR UW N D
ترنجان|T UW RRR UW N D AE N
ترنح|T AE RRR AE N N AE HH AE
ترنيم|T AE RRR N IY M
ترياق|T IY RRR Y AE K
تريث|T AE RRR AE Y Y AE TH AE
تزامن|T AE Z AE M UW N
تزحزح|T AE Z AE HH Z AE HH AE
تزحلق|T AE Z AE HH L UW K
تزعزع|T AE Z AE RH Z AE RH AE
تزويد|T AE Z W IY D
تساءل|T AE S AE Q AE L AE
تساقط|T AE S AE K UW T
تسامح|T AE S AE M UW HH
تساوى|T UW S AE W AE
تسبسب|T AE S AE B S AE B AE
تسريب|T AE S RRR IY B
تسع|T IY S RH
تسعة|T IY S RH AE
تسعمائة|T IY S RH UW M IY Q AE
تسعون|T IY S RH UW N
تسكع|T AE S AE K K AE RH AE
تسلط|T AE S AE L L AE T AE
تسلق|T AE S AE L L UW K
تسلل|T AE S AE L L AE L AE
تسلم|T AE S AE L L UW M
تسلية|T AE S L IY Y AE
تسويق|T AE S W IY K
تسييس|T AE S Y IY S
تشاعر|T AE SH AE RH AE RRR AE
تشالة|T AE SH SH AE L AE
تشبث|T AE SH AE B B AE TH AE
تشخيصي|T AE SH HH IY S IY Y Y
تشرفنا|T AE SH AE RRR RRR AE F N AE
تشكيك|T AE SH K IY K
تشنج|T AE SH AE N N UW D
تشهل|T AE SH AE HH HH AE L AE
تشويق|T AE SH W IY K
تشيكوسلوفاكيا|T SH IY K UW S L UW V AE K IY Y AE
تشيلي|T SH IY L IY
تصاءى|T AE S AE Q AE
تصادأ|T AE S AE D AE Q AE
تصادف|T AE S AE D UW F
تصادم|T AE S AE D UW M
تصاعدي|T AE S AE RH UW D IY Y Y
تصالح|T AE S AE L AE HH AE
تصبصب|T AE S AE B S AE B AE
تصبيرة|T AE S B IY RRR AE
تصتم|T AE S AE T T AE M AE
تصدير|T AE S D IY RRR
تصرف|T AE S AE RRR RRR UW F
تصعيد|T AE S RH IY D
تصغير|T AE S HH IY RRR
تصفح|T AE S AE F F AE HH AE
تصميم|T AE S M IY M
تصنيف|T AE S N IY F
تصهين|T AE S AE HH Y UW N
تصوير|T AE S W IY RRR
تضاد|T AE D AE D D AE
تضامني|T AE D AE M UW N IY Y Y
تضرر|T AE D AE RRR RRR UW RRR
تضمن|T AE D AE M M UW N
تطاير|T AE T AE Y AE RRR AE
تطبب|T AE T AE B B AE B AE
تطبيق|T AE T B IY K
تطفل|T AE T AE F F AE L AE
تطوان|T IY T W AE N
تعادل|T AE RH AE D AE L AE
تعافى|T AE RH AE F AE
تعالم|T AE RH AE L AE M AE
تعالى|T AE RH AE L AE
تعاير|T AE RH AE Y AE RRR AE
تعدى|T AE RH AE D D AE
تعذب|T AE RH AE DH DH AE B AE
تعرض|T AE RH AE RRR RRR AE D AE
تعرية|T AE RH RRR IY Y AE
تعريف|T AE RH RRR IY F
تعزب|T AE RH AE Z Z AE B AE
تعزل|T AE RH AE Z Z AE L AE
تعزم|T AE RH AE Z Z AE M AE
تعس|T AE RH AE S AE
تعسفي|T AE RH AE S S UW F IY Y Y
تعشق|T AE RH AE SH SH AE K AE
تعشن|T AE RH AE SH SH AE N AE
تعشيقة|T AE RH IY SH IY K AE
تعصب|T AE RH AE S S UW B
تعصر|T AE RH AE S S AE RRR AE
تعطى|T UW RH T AE
تعفج|T AE RH AE F F AE D AE
تعلة|T AE RH IY L L AE
تعليق|T AE RH L IY K
تعليم|T AE RH L IY M
تعويذة|T AE RH W IY DH AE
تعين|T AE RH AE Y Y AE N AE
تغذية|T AE HH DH IY Y AE
تغريد|T AE HH RRR IY D
تغريدة|T AE HH RRR IY D AE
تغلب|T AE HH AE L L AE B AE
تغمى|T AE HH AE M M AE
تغوط|T AE HH AE W W AE T AE
تغيير|T AE HH Y IY RRR
تفاجأ|T AE F AE D AE Q AE
تفاح|T UW F F AE HH
تفاحة|T UW F F AE HH AE
تفادى|T AE F AE D AE
تفاف|T IY F AE F
تفاوض|T AE F AE W UW D
تفرغ|T AE F AE RRR RRR UW HH
تفريط|T AE F RRR IY T
تفريغ|T AE F RRR IY HH
تفسير|T AE F S IY RRR
تفسيري|T AE F S IY RRR IY Y Y
تفصيل|T AE F S IY L
تفقد|T AE F AE K K AE D AE
تفوق|T AE F AE W W UW K
تقاعس|T AE K AE RH UW S
تقبض|T AE K AE B B AE D AE
تقدد|T AE K AE D D AE D AE
تقدر|T AE K AE D D AE RRR AE
تقدس|T AE K AE D D AE S AE
تقدم|T AE K AE D D UW M
تقدمي|T AE K AE D D UW M IY Y Y
تقديم|T AE K D IY M
تقرأ|T AE K AE RRR RRR AE Q AE
تقرح|T AE K AE RRR RRR AE HH AE
تقرر|T AE K AE RRR RRR AE RRR AE
تقريبا|T AE K RRR IY B AE N
تقرير|T AE K RRR IY RRR
تقزز|T AE K AE Z Z AE Z AE
تقضب|T AE K AE D D AE B AE
تقضى|T UW K D AE
تقليد|T AE K L IY D
تقليدي|T AE K L IY D IY Y Y
تقني|T IY K N IY Y Y
تقوض|T AE K AE W W AE D AE
تقوى|T AE K W AE
تقويم|T AE K W IY M
تقيأ|T AE K AE Y Y AE Q AE
تقيؤ|T AE K AE Y Y UW Q
تقية|T AE K IY Y Y AE
تكاتب|T AE K AE T UW B
تكدس|T UW K D AE S UW
تكديس|T AE K D IY S
تكشف|T AE K AE SH SH AE F AE
تكعيب|T AE K RH IY B
تكفير|T AE K F IY RRR
تكفيري|T AE K F IY RRR IY Y Y
تكلم|T AE K AE L L UW M
تكميلي|T AE K M IY L IY Y Y
تكويت|T AE K W IY T
تكية|T AE K IY Y Y AE
تل|T AE L L
تلا|T AE L AE
تلاش|T AE L AE SH IY N
تلاشى|T AE L AE SH AE
تلاصق|T AE L AE S UW K
تلاوم|T AE L AE W UW M
تلبرل|T AE L AE B RRR UW L
تلحين|T AE L HH IY N
تلعثم|T AE L AE RH TH AE M AE
تلغراف|T IY L IY HH RRR AE F
تلفاز|T IY L F AE Z
تلفاف|T IY L F AE F
تلفت|T AE L AE F F AE T AE
تلفون|T UW L F UW N AE
تلقاء|T IY L K AE Q AE
تلقى|T AE L AE K K AE
تلك|T IY L K AE
تلم|T AE L AE M
تلميح|T AE L M IY HH
تلميذ|T IY L M IY DH
تلهف|T AE L AE HH HH AE F AE
تليس|T IY L L IY S
تم|T AE M M AE
تمادى|T AE M AE D AE
تمارة|T AE M AE RRR AE
تماسك|T AE M AE S UW K
تماشى|T AE M AE SH AE
تماما|T AE M AE M AE N
تمتم|T AE M T AE M AE
تمتمة|T AE M T AE M AE
تمرد|T AE M AE RRR RRR UW D
تمركز|T AE M AE RRR K AE Z AE
تمرين|T AE M UW RRR RRR IY N AE
تمساح|T IY M S AE HH
تمسيح|T AE M S IY HH
تمسيد|T AE M S IY D
تمطى|T AE M AE T T AE
تململ|T AE M AE L M AE L AE
تمنى|T AE M AE N N AE
تمهل|T AE M AE HH HH AE L AE
تمهيد|T AE M HH IY D
تميس|T AE M AE Y UW1 Y UW1 AE S AE
تمييز|T AE M Y IY Z
تنازع|T AE N AE Z AE RH AE
تنازلي|T AE N AE Z UW L IY Y Y
تناسق|T AE N AE S UW K
تناسى|T AE N AE S AE
تناعس|T AE N AE RH AE S AE
تناغم|T AE N AE HH UW M
تناقض|T AE N AE K UW D
تنامى|T AE N AE M AE
تناوب|T AE N AE W UW B
تناوم|T AE N AE W UW M
تنبول|T UW M B UW L
تنجرة|T AE N D AE RRR AE
تنحى|T AE N AE HH HH AE
تنديل|T IH N D EH0 L
تنرفز|T AE N AE RRR F AE Z AE
تنزانيا|T AE N Z AE N Y AE
تنزل|T AE N AE Z Z AE L AE
تنزه|T AE N AE Z Z AE HH AE
تنسيق|T AE N S IY K
تنظيم|T AE N DH IY M
تنفس|T UW N F AE S UW
تنفيذ|T AE N F IY DH
تنقض|T AE N K AE D IY
تنميل|T AE N M IY L
تنهد|T AE N AE HH HH AE D AE
تنوب|T AE N N UW B
تنور|T AE N N UW RRR
تنورة|T AE N N UW RRR AE
تنوير|T AE N W IY RRR
تنين|T IY N N IY N
تهالك|T AE HH AE L AE K AE
تهتلر|T AE HH AE T L AE RRR AE
تهج|T AE HH AE D D IY N
تهجى|T AE HH AE D D AE
تهدج|T AE HH AE D D AE D AE
تهدد|T AE HH AE D D AE D AE
تهدل|T AE HH AE D D UW L
تهديد|T AE HH D IY D
تهذيب|T AE HH DH IY B
تهكم|T AE HH AE K K AE M AE
تهلين|T AE HH L IY N
تهيأ|T AE HH AE Y Y AE Q AE
توأم|T AE W Q AE M
توارى|T AE W AE RRR AE
توازى|T AE W AE Z AE
تواص|T AE W AE S IY N
تواصى|T AE W AE S AE
تواضع|T AE W AE D UW RH
تواطأ|T AE W AE T AE Q AE
تواطؤ|T AE W AE T UW Q
تواقف|T AE W AE K UW F
توبة|T OW0 B AA
توتيا|T UW T IY Y AE
توتياء|T UW T IY Y AE Q
توج|T UW D
توجه|T AE W AE D D AE HH AE
توجو|T OW0 G OW0
تودري|T UW D AE RRR IY Y Y
تودريج|T UW D AE RRR IY D
توراة|T AH0 W RRR AA T
تورم|T AE W AE RRR RRR UW M
توزيع|T AE W Z IY RH
توسع|T AE W AE S S AE RH AE
توصية|T AE W S IY Y AE
توضح|T AE W AE D D AE HH AE
توظيف|T AE W DH IY F
توعوي|T AE W RH AE W IY Y Y
توعية|T AE W RH IY Y AE
توغو|T OW0 HH OW0
توفى|T AE W AE F F AE
توفيق|T AE W F IY K
توقف|T AE W AE K K UW F
توقيف|T AE W K IY F
توكيد|T AE W K IY D
تومان|T UW M AE N
تونس|T UW N UW S
توهج|T AE W AE HH HH AE D AE
تيش|T IY SH
تيغار|T IY HH AE RRR
تيقظ|T AE Y AE K K AE DH AE
تيموثاوس|T IY M UW TH AE W UW S
تين|T IY N
تينة|T IY N AE
ث|TH AE Q
ثآليل|TH AE Q AE L IY L
ثؤلول|TH UW Q L UW L
ثاء|TH AE Q
ثابت|TH AE B IY T
ثالوث|TH AE L UW TH
ثان|TH AE N IY N
ثانوي|TH AE N AE W IY Y Y
ثانية|TH AE N IY Y AE
ثاودسيوس|TH AE W UW D UW S IY Y UW S
ثداء|TH UW D D AE Q
ثدياء|TH AE D Y AE Q
ثديي|TH AE D Y IY Y Y
ثدييات|TH AE D Y IY Y Y AE T
ثرب|TH AE RRR B
ثروة|TH AE RRR W AE
ثرى|TH AE RRR AE N
ثريد|TH AE RRR IY D
ثعبان|TH UW RH B AE N
ثعلب|TH AE RH L AE B
ثفروق|TH UW F RRR UW K
ثقافة|TH AE K AE F AE
ثقافي|TH AE K AE F IY Y Y
ثقبة|TH UW K B AE
ثقة|TH IY K AE
ثقل|TH IY K L UW N
ثقيل|TH AE K IY L
ثكل|TH AE K IY L AE
ثلاثة|TH AE L AE TH AE
ثلاثون|TH AE L AE TH UW N AE
ثلاجة|TH AE L L AE D AE
ثلة|TH UW L L AE
ثلج|TH AE L D
ثم|TH UW M M AE
ثمان|TH AE M AE N IY N
ثمانون|TH AE M AE N UW N
ثمانية|TH AE M AE N IY Y AE
ثمر|TH AE M AE RRR
ثمن|TH UW M UW N
ثنايا|TH AE N AE Y AE
ثنوية|TH AE N AE W IY Y Y AE
ثوب|TH AE W B
ثور|TH AE W RRR
ثورة|TH AE W RRR AE
ثوري|TH UW RRR IY
ثوم|TH UW M
ثيتل|TH AE Y T AE L
ثيوقراطي|TH IY Y UW K RRR AE T IY Y Y
ج|D IY M
جأش|D AE Q SH
جاء|D AE Q IY N
جائحة|D AE Q IY HH AE
جائز|D AE Q IY Z
جائع|D AE Q IY RH
جاب|D AE B IY N
جابية|D AE B IY Y AE
جاد|D AE D AE
جادل|D AE D AE L AE
جاذبية|D AE DH IY B IY Y Y AE
جار|D AE RRR
جارة|D AE RRR AE
جارية|D AE RRR IY Y AE
جازون|K AE Z UW N
جاع|D AE RH AE
جاف|D AE F F
جاكيت|D AE K IY T
جام|D AE M
جامايكا|D AE M AE Y K AE
جامع|G AE M IY RH
جامعة|D AE M IY RH AE
جاموس|D AE M UW S
جانرك|D AE N AE RRR IY K
جاهز|D AE HH IY Z
جاوب|D AE W AE B AE
جاورجيوس|D AE W UW RRR D IY Y UW S
جاورس|D AE W AE RRR S
جاوشير|D AE W AE SH IY RRR
جبان|D AE B B AE N
جبانات|D AE B AE N AE T
جبة|D UW B B AE
جبت|D IY B T
جبران|D UW B RRR AE N
جبروت|D AE B AE RRR UW T
جبس|D IY B S
جبل|D AE B L
جبن|D UW B N
جبناء|D UW B AE N AE Q
جبه|D AE B AE HH AE
جبهة|D AE B HH AE
جبيز|D AE B IY Z
جثة|D UW TH TH AE
جثجاث|D AE TH D AE TH
جثمان|D UW TH M AE N
جحا|D UW HH AE
جحر|D UW HH RRR
جحفل|D HH F AE L AE
جخى|D AE HH HH AE
جد|D AE D D
جدا|D IY D D AE N
جدار|D IY D AE RRR
جدد|D UW D AE D
جدر|D AE D UW RRR AE
جدري|D UW D AE RRR IY Y Y
جدع|D AE D RH
جدوار|D AE D W AE RRR
جدول|D AE D W AE L
جدوى|D AE D W AE
جديد|D AE D IY D
جذاب|D AE DH DH AE B
جذام|D UW DH AE M
جذر|D IY DH RRR
جذع|D IY DH RH
جذمور|D UW DH M UW RRR
جذوع|D UW DH UW RH
جرأة|D UW RRR Q AE
جرؤ|D AE RRR UW Q AE
جرابي|D IY RRR AE B IY Y Y
جراحة|D IY RRR AE HH AE
جراد|D AE RRR AE D
جرادة|D AE RRR AE D AE
جرارة|D AE RRR RRR AE RRR AE
جرافة|D AE RRR RRR AE F AE
جربندية|D AE RRR AE B AE N D IY Y Y AE
جربوز|D AE RRR B UW Z
جربوع|D AE RRR B UW RH
جرثوم|D UW RRR TH UW M
جرجان|D AE RRR D AE N
جرجس|D UW RRR D UW S
جرجير|D IY RRR D IY RRR
جردل|D AE RRR D AE L
جرذ|D UW RRR AE DH
جرعة|D UW RRR RH AE
جرو|D UW RRR W
جريب|D UW RRR AE Y B
جريد|D AE RRR IY D
جريدة|D AE RRR IY D AE
جريمة|D AE RRR IY M AE
جرينلاند|G IY RRR IY N L AE N D
جز|D AE Z Z AE
جزء|D UW Z Q
جزئي|D UW Z Q IY Y Y
جزاء|D IY Z AE Q
جزائري|D AE Z AE Q IY RRR IY Y Y
جزدان|D UW Z D AE N
جزع|D AE Z AE RH AE
جزمازج|D AE Z M AE Z AE D
جزمازق|D AE Z M AE Z AE K
جزمازك|D AE Z M AE Z AE K
جزيرة|D AE Z IY RRR AE
جسارة|D AE S AE RRR AE
جسامة|D AE S AE M AE
جسر|D IY S RRR
جسم|D IY S M
جسمان|D UW S M AE N
جسماني|D UW S M AE N IY Y Y
جسور|D UW S UW RRR
جسيم|D UW S AE Y M
جشاء|D UW SH AE Q
جص|D IY S S
جعة|D IY RH AE
جعضيض|D AE RH D IY D
جعفر|D AE RH F AE RRR
جعفيل|D AE RH F IY L
جعل|D AE RH L
جفاء|D AE F AE Q
جفن|D IY F IY N
جفنة|D AE F N AE
جلاد|D AE L L AE D
جلب|D AE L AE B AE
جلباب|D IY L B AE B
جلجلان|D UW L D UW L AE N
جلد|D IY L D
جلس|D AE L AE S AE
جلنار|D UW L L AE N AE RRR
جلنجبين|D UW L L AE N D UW B IY N
جلهاب|D IY L HH AE B
جلهم|D UW L HH UW M
جلوز|D IY L L AE W Z
جلي|D AE L IY Y Y
جليد|D AE L IY D
جليس|D AE L IY S
جم|D AE M M
جما|D AE M M AE N
جماد|D AE M AE D
جمادى|D UW M AE D AE
جماعة|D AE M AE RH AE
جمال|D IY M AE L
جمان|D UW M AE N
جمانة|D UW M AE N AE
جمجمة|D UW M D UW M AE
جمدانة|D AE M AE D AE N AE
جمع|D AE M RH
جمعة|D UW M RH AE
جمعي|D AE M RH IY Y Y
جمعية|D AE M RH IY Y Y AE
جمل|D UW M AE L
جملة|D UW M L AE
جمهور|D UW M HH UW RRR
جمهورية|D UW M HH UW RRR IY Y Y AE
جميز|D UW M M AE Y Z
جميزة|D UW M M AE Y Z
جميع|D AE M IY RH
جميل|G AE M IY L
جميلة|D AE M IY L AE
جنائي|D IY N AE Q IY Y Y
جناح|D UW N AE HH
جنازة|ZH N AE Z AE
جنب|D UW N IY B AE
جنة|D AE N N AE
جنح|D UW N HH
جندب|D UW N D UW B
جندبادستر|D UW N D UW B AE D AE S T AE RRR
جندي|D UW N D IY Y Y
جندية|D UW N D IY Y Y AE
جنس|ZH IY N S
جنسي|D IY N S IY Y Y
جنسية|D IY N S IY Y Y AE
جنطيانا|D UW N T AE Y AE N AE
جنك|D UW N K
جنوب|G AE N UW B
جنى|D AE N AE
جني|D UW N N IY
جنيف|D IY N IY F
جنين|D AE N IY N
جنينة|D UW N AE Y N AE
جنيه|G IY N EH0 HH
جهاد|D IY HH AE D
جهادي|D IY HH AE D IY Y Y
جهة|D IY HH AE
جهد|D UW HH D
جهنم|D AE HH AE N N AE M
جو|ZH AE W W
جواب|D AE W AE B
جواد|D AE W AE D
جوارش|D AE W AE RRR IY SH
جوافة|D UW W AE F AE
جواهري|D AE W AE HH IY RRR IY Y Y
جودر|D AE W D AE RRR
جوذاب|D UW DH AE B
جوذر|D AE W DH AE RRR
جور|D AE W RRR
جورب|D AE W RRR AE B
جورجي|D UW RRR D IY Y Y
جورجيا|D UW RRR D IY Y AE
جوز|D OW0 Z
جوزل|D AE W Z AE L
جولة|D AE W L AE
جولق|D AE W L AE K
جوهر|D AE W HH AE RRR
جوهري|D AE W HH AE RRR IY Y Y
جوي|D AE W W IY Y Y
جيء|D IY Q AE
جيد|D IY D
جيش|D AE Y SH
جيفة|D IY F AE
جيل|D IY L
جيم|D IY M
جين|D IY N
جينز|D IY N Z
ح|HH AE Q
حاء|HH AE Q
حائض|HH AE Q IY D
حائط|HH AE Q IY T
حاجة|HH AE D AE
حاجز|HH AE D IY Z
حاجيات|HH AE D IY Y AE T
حاد|HH AE D D
حادث|HH AE D IY TH
حادثة|HH AE D IY TH AE
حاذق|HH AE DH IY K
حارس|HH AE RRR IY S
حاز|HH AE Z AE
حازوقة|HH AE Z UW K AE
حاسد|HH AE S IY D
حاسم|HH AE S IY M
حاسوب|HH AE S UW B
حاشا|HH AE SH AE
حاص|HH AE S AE
حاضرة|HH AE D IY RRR AE
حاط|HH AE T AE
حاف|HH AE F IY N
حافة|HH AE F F AE
حافظة|HH AE F IY DH AE
حافلات|HH AE F IY L AE T
حافلة|HH AE F IY L AE
حاك|HH AE K AE
حالا|HH AE L AE N
حالب|HH AE L IY B
حالة|HH AE L AE T AE
حامض|HH AA M IH DH
حامول|HH AE M UW L
حان|HH AE N AE
حانوت|HH AE N UW T
حاول|HH AE W AE L AE
حب|HH UW B B
حبارى|HH UW B AE RRR AE
حبالة|HH IY B AE L AE
حبة|HH AE B B AE
حبرج|HH UW B RRR UW D
حبس|HH AE B B AE S AE
حبشي|HH AE B AE SH IY Y Y
حبق|HH AE B AE K AE
حبل|HH AE B L
حبلى|HH UW B L AE
حبن|HH UW B IY N AE
حبيبي|HH AE B IY B IY
حتام|HH AE T T AE M AE
حتما|HH AE T M AE N
حج|HH AE ZH ZH
حجاب|HH IY ZH AE B
حجامة|HH IY D AE M AE
حجة|HH UW D D AE
حجر|HH UW D RRR
حجرة|HH UW D RRR AE
حجفة|HH AE D AE F AE
حجم|HH AE D M
حجن|HH AE D AE N AE
حح|HH UW HH
حد|HH IY D
حدا|HH AE D AE
حدج|HH IY D D UW N
حدد|HH AE D D AE D AE
حدق|HH AE D AE K AE
حدوة|HH IY D W AE
حديث|HH AE D IY TH
حديد|HH AE D IY D
حديقة|HH AE D IY G AE
حذار|HH AE DH AE RRR IY
حذفي|HH AE DH AE F IY Y Y
حذلقة|HH AE DH L AE K AE
حذو|HH AE DH W AE
حر|HH UW RRR RRR
حراري|HH AE RRR AE RRR IY Y Y
حرامي|HH AE RRR AE M IY Y Y
حرباء|HH IY RRR B AE Q
حربة|HH AE RRR B AE
حربث|HH UW RRR B UW TH
حربي|HH AE RRR B IY Y UW N
حرج|HH AE RRR IY D AE
حرجي|HH AE RRR AE D IY Y Y
حرذون|HH IY RRR DH AE W N
حرز|HH IY RRR Z
حرش|HH UW RRR SH
حرشف|HH AE RRR SH AE F
حرص|HH IY RRR S
حرض|HH AE RRR RRR AE D AE
حرف|HH UW RRR F
حرفي|HH IY RRR F IY Y Y
حرق|HH UW RRR G
حرقدة|HH AE RRR K AE D AE
حرقوس|HH AE RRR K UW S
حرقوص|HH AE RRR K UW S
حرمان|HH IY RRR M AE N
حرمل|HH AE RRR M AE L
حرنكش|HH AE RRR AE N K AE SH
حرية|HH UW RRR RRR IY Y Y AE
حرير|HH AE RRR IY RRR
حريش|HH AE RRR IY SH
حريم|HH AE RRR IY M
حز|HH AE Z Z AE
حزاء|HH AE Z AE Q
حزاق|HH UW Z AE K
حزم|HH AE Z AE M AE
حزمة|HH UW Z M AE
حساسي|HH AE S S AE S IY Y Y
حسرة|HH AE S RRR AE
حسك|HH AE S AE K
حسل|HH IY S L
حسنا|HH AE S UW N N AE
حسناء|HH AE S N AE Q
حسين|HH UW S AE Y N
حش|HH AE SH SH AE
حشيش|HH AE SH IY SH
حصاة|HH AE S AE HH
حصاد|HH IY S AE D
حصان|HH IY S AE N
حصبة|HH AE S B AE
حصرم|HH UW S RRR UW M
حصل|HH AE S S AE L AE
حصن|HH UW S UW N
حصوة|HH AE S W AE
حصى|HH AE S AE N
حصير|HH AE S IY RRR
حصيرة|HH AE S IY RRR AE
حضرموت|HH AE D RRR AE M UW T
حضرمي|HH AE D RRR AE M IY Y Y
حطاب|HH AE T T AE B
حطب|HH AE T AE B
حطم|HH AE T T AE M AE
حظي|HH AE DH IY Y AE
حظيرة|HH AE DH IY RRR AE
حفار|HH AE F F AE RRR
حفة|HH AE F F AE
حفر|HH AE F RRR
حفرة|HH UW F RRR AE
حفيد|HH AE F IY D
حفيدة|HH AE F IY D AE
حق|HH UW K K AE
حقا|HH AE K K AE N
حقاب|HH IY K AE B
حقبة|HH IY K B AE
حقد|HH IY K D
حقق|HH UW K AE K
حقل|HH AE K L
حقوقي|HH UW K UW K IY Y Y
حقيقة|HH AE K IY K AE
حكا|HH AE K AE
حكاية|HH IY K AE Y AE
حكة|HH IY K K AE
حكمة|HH IY K M AE
حكومة|HH UW K UW M AE
حكومي|HH UW K UW M IY Y Y
حكى|HH AE K AE
حلال|HH AE L AE L
حلبة|HH UW L B AE
حلبوب|HH UW L B UW B
حلتيت|HH IY L T IY T
حلتيث|HH IY L T IY TH
حلف|HH AE L L AE F AE
حلقة|HH AE L K AE
حلقوس|HH AE L K UW S
حلقوص|HH AE L K UW S
حلقوم|HH UW L K UW M
حلكة|HH UW L K AE
حلول|HH UW L UW L
حليب|HH AE L IY B
حليف|HH AE L IY F
حمار|HH IY M AE RRR
حماس|HH AE M AE S
حماسة|HH AE M AE S AE
حماض|HH UW M M AE D
حماق|HH UW M AE K
حمام|HH IY M AE M
حمامة|HH AE M AE M AE
حمبزان|HH AE M B IY Z AE N
حمزة|HH AE M Z AE HH
حمص|HH UW M M UW S
حمصيص|HH AE M S IY S
حمضي|HH AE M D IY Y Y
حمل|HH IY M L
حملة|HH AE M L AE
حميم|HH AE M IY M
حن|HH AE N N AE
حنان|HH AE N AE N
حنبل|HH AE N B AE L
حنبلي|HH AE N B AE L IY Y Y
حنة|HH IY N N AE
حنجرة|HH AE N D AE RRR AE
حنجري|HH AE N D AE RRR IY Y Y
حندقوق|HH AE N D AE K UW K
حنطبة|HH AE N T AE B AE
حنطة|HH IY N T AE
حنطور|HH AE N T UW RRR
حنظل|HH AE N DH AE L
حنظلة|HH AE N DH AE L AE
حنفي|HH AE N AE F IY Y Y
حنفية|HH AE N AE F IY Y Y AE
حنون|HH AE N UW N
حنيف|HH AE N IY F
حنين|HH AE N IY N
حواء|HH AE W W AE Q
حوائج|HH AE W AE Q IY D
حواجز|HH AE W AE D IY Z
حوار|HH IY W AE RRR
حواري|HH AE W AE RRR IY Y Y
حوافل|HH AE W AE F IY L
حوالب|HH AE W AE L IY B
حوالي|HH AE W AE L AE Y
حوب|HH UW B
حوجلة|HH AE W D AE L AE
حوذان|HH AE W DH AE N
حوراء|HH AE W RRR AE Q
حورس|HH UW RRR UW S
حورية|HH UW RRR IY Y Y AE
حوزة|HH AE W Z AE
حوض|HH AE W D
حوول|HH UW W IY L AE
حيا|HH AE Y Y AE
حياة|HH AE Y AE HH
حياطة|HH IY Y AE T AE
حية|HH AE Y Y AE
حيث|HH AE Y TH UW
حيثيات|HH AE Y TH IY Y Y AE T
حيثية|HH AE Y TH IY Y Y AE
حيران|HH AE Y RRR AE N
حيرة|HH AE Y RRR AE
حيصل|HH AE Y S AE L
حيطة|HH IY T AE
حين|HH IY N AE
حينئذ|HH IY N AE Q IY DH IY N
حينذاك|HH IY N AE DH AE K AE
حينما|HH IY N AE M AE
حيهل|HH AE Y Y AE HH AE L
حيوان|HH AE Y AE W AE N
حيواني|HH AE Y AE W AE N IY Y Y
حيوة|HH AE Y AE HH
خ|HR AE Q
خاء|HH AE Q
خابور|HH AE B UW RRR
خابية|HH AE B IY Y AE
خاتم|HH AE T IY M
خادم|HH AE D IY M
خارج|HH AE RRR IY D
خارجي|HH AE RRR IY D IY Y Y
خارصين|HH AE RRR AE S IY N
خارصيني|HH AE RRR AE S IY N IY Y Y
خاطئ|HH AE T IY Q
خاطئة|HH AE T IY Q AE
خاف|HH AE F AE
خافور|HH AE F UW RRR
خالد|HH AE L IY D
خالف|HH AE L AE F AE
خالق|HH AE L IY K
خامر|HH AE M AE RRR AE
خامس|HH AE M IY S
خاو|HH AE W IY N
خبا|HH AE B AE
خباز|HH UW B B AE Z
خبر|HH UW B RRR
خبز|HH UW B Z
خبيئة|HH AE B IY Q AE
خبياري|HH IY B Y AE RRR IY Y Y
خبير|HH AE B IY RRR
ختان|HH IY T AE N
خث|HH UW TH TH
خثي|HH IY TH Y
خجول|HH AE D UW L
خد|HH AE D D
خداج|HH IY D AE D
خدش|HH AE D SH
خديوي|HH IY D AE Y W IY Y Y
خرئ|HH AE RRR IY Q AE
خراء|HH IY RRR AE Q
خراب|HH AE RRR AE B
خرافة|HH UW RRR AE F AE
خرافي|HH UW RRR AE F IY Y Y
خربز|HH IY RRR B IY Z
خربش|HH AE RRR B AE SH AE
خرت|HH AE RRR AE T AE
خرج|HH UW RRR D
خردل|HH AE RRR D AE L
خرزة|HH UW RRR Z AE
خرس|HH AE RRR IY S AE
خرسانة|HH AE RRR AE S AE N AE
خرشوف|HH UW RRR SH UW F
خرطال|HH AE RRR T AE L
خرطوش|HH AE RRR T UW SH
خرفة|HH UW RRR F AE
خرقة|HH IY RRR K AE
خرمال|HH UW RRR M AE L
خرنباش|HH UW RRR AE N B AE SH
خرنق|HH IY RRR N IY K
خروف|HH AE RRR UW F
خريبكة|HH UW RRR IY B G AE
خريطة|HH AE RRR IY T AE
خريف|HH AE RRR IY F
خز|HH AE Z Z
خزاف|HH AE Z Z AE F
خزامى|HH UW Z AE M AE
خزان|HH AE Z Z AE N
خزانة|HH IY Z AE N AE
خزز|HH UW Z AE Z
خزعبلة|HH UW Z AE RH B IY L AE
خزف|HH AE Z AE F
خزنة|HH AE Z N AE
خزينة|HH AE Z IY N AE
خسأ|HH AE S AE Q AE
خسئ|HH AE S IY Q AE
خسارة|HH AE S AE RRR AE
خسوف|HH UW S UW F
خشاب|HH AE SH SH AE B
خشخاش|HH AE SH HH AE SH
خشن|HH AE SH IY N
خشوع|HH UW SH UW RH
خشي|HH AE SH IY Y AE
خصص|HH AE S S AE S AE
خصفة|HH AE S F AE
خصوبة|HH UW S UW B AE
خصوص|HH UW S UW S
خصوصا|HH UW S UW S AE N
خصوصي|HH UW S UW S IY Y Y
خصوم|HH UW S UW M
خصيب|HH AE S IY B
خصية|HH UW S Y AE
خضار|HH AE D D AE RRR
خضخض|HH AE D HH AE D AE
خط|HH AE T T AE
خطء|HH IY T Q
خطئ|HH AE T IY Q AE
خطام|HH IY T AE M
خطة|HH UW T T AE
خطف|HH AE T IY F AE
خطمي|HH IY T M IY Y Y
خطيئة|HH AE T IY Q AE
خطيب|HH AE T IY B
خف|HH AE F F AE
خفة|HH IY F F AE
خفج|HH AE F AE D
خفر|HH AE F AE RRR AE
خفق|HH AE F AE K AE
خفى|HH AE F AE
خلاص|HR AA L AA S
خلاصة|HH UW L AE S AE
خلاط|HH IY L AE T
خلاعي|HH AE L AE RH IY Y Y
خلافة|HH IY L AE F AE
خلر|HH UW L L AE RRR
خلع|HH UW L RH
خلف|HH AE L F AE
خلفي|HH AE L F IY Y Y
خلق|HH AE L K
خلقي|HH UW L UW K IY Y Y
خلنجان|HH AE L AE N D AE N
خلوة|HH AE L W AE
خلى|HH AE L L AE
خلية|HH AE L IY Y Y AE
خليجي|HH AE L IY D IY Y Y
خليط|HH AE L IY T
خليف|HH AE L IY F
خليفة|HH AE L IY F AE
خليق|HH AE L IY K
خليقة|HH AE L IY K AE
خمسة|HH AE M S AE
خمسون|HH AE M S UW N AE
خمير|HH IY M M IY RRR
خناق|HH UW N AE K
خنجر|HH AE N D AE RRR
خندريس|HH AE N D AE RRR IY S
خنزير|HR AH0 N Z IY RRR
خنشار|HH IY N SH AE RRR
خنصور|HH AE N S UW RRR
خنفساء|HH UW N F UW S AE Q
خنق|HH AE N AE K AE
خنيفرة|HH UW N AE Y F IY RRR AE
خواتم|HH AE W AE T IY M
خوارزم|HH AE W AE RRR IY Z M
خوخ|HH AE W HH
خوخة|HH AE W HH AE
خوذة|HH UW DH AE
خور|HH AE W RRR
خوف|HH AE W F
خولنجان|HH UW L AE N D AE N
خوي|HH UW W AE Y Y
خيار|HH IY Y AE RRR
خياط|HH AE Y Y AE T
خيالي|HH AE Y AE L IY Y Y
خيبة|HH AE Y B AE
خير|HH AE Y RRR
خيرات|HH AE Y RRR AE T
خيرة|HH IY RRR AE
خيزان|HH IY Z AE N
خيزران|HH AE Y Z UW RRR AE N
خيزرانة|HH AE Y Z UW RRR AE N
خيط|HH AE Y T
خيلان|HH AE Y AE L AE N
خيمة|HH AE Y M AE
خيوط|HH UW Y UW T
د|D AE L
داء|D AE Q
دائخ|D AE Q IY HH
دائرة|D AE Q IY RRR AE HH
دائمي|D AE Q IY M IY Y Y
دابر|D AE B IY RRR
دابرة|D AE B IY RRR AE
داخ|D AE HH AE
داخرقان|D AE HH AE RRR RRR AE K AE N
داخل|D AE HH IY L AE
داذي|D AE DH IY Y Y
دارجة|D AE RRR IY D AE
دارس|D AE RRR IY S
دارشيشعان|D AE RRR SH IY SH AE RH AE N
دارفلفل|D AE RRR F IY L F IY L
داركيسة|D AE RRR K IY S AE
دارويني|D AE RRR W IY N IY Y Y
داع|D AE RH IY N
داعب|D AE RH AE B AE
داعش|D AE RH IY SH
دافئ|D AE F IY Q
دال|D AE L
داليا|D AE L IY Y AE
دالية|D AE L IY Y AE
داود|D AE W UW D
داوود|D AE W UW D
داية|D AE Y AE
دب|D UW B B
دباء|D UW B B AE Q
دبار|D IY B AE RRR
دباغ|D IY B AE HH
دبج|D AE B B AE D AE
دبغ|D AE B AE HH AE
دبقي|D IY B K IY Y Y
دبلج|D AE B L AE D AE
دبلجة|D AE B L AE D AE
دبوس|D AE B B UW S
دبي|D UW B AE Y Y
دبيل|D AE B IY L
دثر|D AE TH RRR
دجاج|D AE D AE D
دجاجة|D AE D AE D AE
دجلة|D IY D L AE
دجن|D AE D D AE N AE
دحرج|D AE HH RRR AE D AE
دخان|D UW HH HH AE N
دخس|D UW HH AE S
دخل|D AE HH HH AE L AE
درأ|D AE RRR AE Q AE
دراجة|D AE RRR RRR AE D AE
دراسي|D IY RRR AE S IY Y Y
دراماتيكي|D IY RRR AE M AE T IY K IY Y Y
درباس|D IY RRR B AE S
دربس|D AE RRR B AE S AE
دربوكة|D AE RRR B UW K AE
درجة|D AE RRR AE D AE
دردق|D AE RRR D AE K
دردي|D UW RRR D IY Y Y
درزن|D AE RRR Z AE N
درس|D AE RRR S
درع|D IY RRR RH
درفيل|D AE RRR F IY L
درقة|D AE RRR AE K AE
درك|D AE RRR AE K
دركي|D AE RRR AE K IY Y Y
درونج|D AE RRR AE W N IY D
درياق|D IY RRR Y AE K
دزينة|T UW Z Z IY N AE
دساتير|D AE S AE T IY RRR
دسار|D IY S AE RRR
دستة|D AE S T AE
دستج|D AE S T AE D
دستجة|D AE S T AE D AE
دستور|D IH S T UW RRR
دستوري|D UW S T UW RRR IY Y Y
دشداشة|D IH SH D AE SH AH0
دشمة|D UW SH M AE
دعا|D AE RH AE
دعاء|D UW RH AE Q
دعسوقة|D UW RH S UW K AE
دعش|D AE RH RH AE SH AE
دعموص|D UW RH M UW S
دعوة|D AE RH W AE
دغبوس|D UW HH B UW S
دغدغ|D AE HH D AE HH AE
دغفل|D AE HH F AE L
دغموس|D AE HH M UW S
دفء|D IY F Q
دفاع|D IY F AE RH
دفتر|D AE F T AE RRR
دفلى|D IY F L AE
دفيء|D AE F IY Q
دقع|D AE K IY RH AE
دقنيش|D AE K N IY SH
دقيق|D AE K IY K
دقيقة|D AE G IY G AE
دكا|D AE K AE
دكان|D UW K K AE N
دكتور|D IH K T OW0 RRR
دل|D AE L L AE
دلاع|D UW L L AE RH
دلاعة|D AE L L AE RH AE
دلال|D AE L L AE L
دلب|D UW L B
دلف|D AE L AE F AE
دلق|D AE L AE K AE
دلل|D AE L L AE L AE
دلو|D AE L W
دليل|D AE L IY L
دم|D UW M
دماغ|D IY M AE HH
دماغي|D IY M AE HH IY Y Y
دمج|D AE M AE D AE
دمجانة|D AE M AE D AE N AE
دمدم|D AE M D AE M AE
دمع|D AE M RH
دمغة|D AE M HH AE
دمقس|D IY M AE K S
دملوج|D UW M L UW D
دمنة|D IY M N AE
دمي|D AE M Y
دمية|D UW M Y AE
دن|D IY N N AE
دناوة|D AE N AE W AE
دند|D AE N D
دنر|D AE N N AE RRR AE
دنو|D UW N UW W W
دنيا|D UW N Y AE
دهس|D AE HH S
دهشة|D AE HH SH AE
دهقان|D UW HH K AE N
دهليز|D IY HH L IY Z
دهنج|D AE HH N AE D
دواة|D AE W AE HH
دواسة|D AE W W AE S AE
دوافع|D AE W AE F IY RH
دوخة|D AE W HH AE
دودة|D UW D AE
دورة|D AE W RRR AE
دورق|D AE W RRR AE K
دوري|D AE W RRR IY Y Y
دوسر|D AE W S AE RRR
دوش|D UW SH
دوغ|D UW HH
دول|D UW W AE L
دولاب|D UW L AE B
دولار|D OW0 L AE RRR
دولة|D AE W L AE
دولي|D UW W AE L IY Y Y
دوليا|D UW W AE L IY Y Y AE N
دومان|D UW M AE N
دون|D UW N AE
دونم|D UW N UW M
دونمة|D UW N M AE
دوى|D AE W AE
دويبة|D UW W AE Y B B AE
دياقود|D IY Y AE K UW D
ديان|D AE Y Y AE N
ديانات|D IY Y AE N AE T
ديباج|D IY B AE D
ديبوذ|D AE Y B UW DH
دير|D AE Y RRR
ديس|D IY S
ديسق|D IY S AE K
ديسم|D AE Y S AE M
ديسمبر|D IY S IY M B IY RRR
ديك|D IY K
ديماس|D IY M AE S
ديمومة|D AE Y M UW M AE
دين|D IY N AE
دينار|D IY N AE RRR
ديناميكا|D IY N AE M IY K AE
ذ|DH AE L
ذئب|DH IY Q B
ذئبة|DH IY Q B AE
ذاب|DH AE B AE
ذاق|DH AE K AE
ذاكرة|DH AE K IY RRR AE
ذال|DH AE L
ذبابة|DH UW B AE B AE
ذبحة|DH AE B HH AE
ذبحي|DH AE B HH IY Y Y
ذبول|DH UW B UW L
ذخيرة|DH AE HH IY RRR AE
ذراع|DH IY RRR AE RH
ذرة|DH UW RRR AE
ذروة|DH UW RRR W AE
ذرية|DH UW RRR RRR IY Y Y AE
ذريع|DH AE RRR IY RH
ذريعة|DH AE RRR IY RH AE
ذعن|DH AE RH IY N AE
ذكاء|DH AE K AE Q
ذكر|DH IY K RRR
ذكرى|DH IY K RRR AE
ذلك|DH AE L IY K AE
ذلل|DH AE L L AE L AE
ذليل|DH AE L IY L
ذمة|DH IY M M AE
ذمم|DH IY M AE M
ذميم|DH AE M IY M
ذنب|DH AE N N AE B AE
ذهب|DH AE HH HH AE B AE
ذهن|DH IY HH N
ذو|DH UW
ذوب|DH AE W W AE B AE
ذوق|DH AE W K
ذيل|DH AE Y L
ر|RRR AE Q
رأس|RRR AE Q Q AE S AE
رأسمال|RRR AE Q S M AE L
رأسي|RRR AE Q S IY Y Y
رأل|RRR AE Q L
رأى|RRR AE Q AE
رأي|RRR AE Q Y
رؤوس|RRR UW Q UW S
رؤيا|RRR UW Q Y AE
رئاسة|RRR IY Q AE S AE
رئاسي|RRR IY Q AE S IY Y Y
رئوي|RRR IY Q AE W IY Y Y
رئيس|RRR AE Q IY S
رئيسي|RRR AE Q IY S IY Y Y
راء|RRR AE Q IY N
راءى|RRR AE Q AE
رائب|RRR AE Q IY B
رائحة|RRR AE Q IY HH AE
رائس|RRR AE Q IY S
رائع|RRR AE Q IY RH
رائعة|RRR AE Q IY RH AE
راب|RRR AE B AE
رابط|RRR AE B IY T
رابطة|RRR AE B IY T AE
رابع|RRR AE B IY RH
راتينج|RRR AE T IY N AE D
راجل|RRR AE D IY L
راجمة|RRR AE D IY M AE
راحة|RRR AE HH AE
راحل|RRR AE HH IY L
رادف|RRR AE D AE F AE
رادود|RRR AE D UW D
راسخت|RRR AE S UW HH T
راض|RRR AE D IY N
راع|RRR AE RH IY N
راعدة|RRR AE RH IY D AE
رافد|RRR AE F IY D
رافعة|RRR AE F IY RH AE
راقب|RRR AE K AE B AE
راقص|RRR AE K IY S
راكب|RRR AE K IY B
رام|RRR AE M AE
ران|RRR AE N AE
راود|RRR AE W AE D AE
راوند|RRR AE W AE N D
رب|RRR UW B B AE
رباط|RRR IY B AE T
رباعيات|RRR UW B AE RH IY Y Y AE T
ربت|RRR AE B B AE T AE
ربما|RRR UW B B AE M AE
ربوة|RRR UW B W AE
ربيثاء|RRR UW B AE Y TH AE Q
ربيع|RRR AE B IY RH
رتيل|RRR UW T AE Y L
رتيلاء|RRR UW T AE Y L AE Q
رتيلة|RRR UW T AE Y L AE
رتينج|RRR AE T IY N AE D
رثية|RRR AE TH Y AE
رج|RRR AE D D AE
رجب|RRR AE D AE B
رجرج|RRR AE D RRR AE D AE
رجع|RRR UW D UW RH
رجفة|RRR AE D F AE
رجل|RRR IY D L
رجلة|RRR UW D L AE
رجمة|RRR UW D M AE
رجينة|RRR AE D IY N AE
رح|RRR UW HH
رحاية|RRR AE HH AE Y AE
رحب|RRR UW HH B
رحمة|RRR AE HH M AE
رحمن|RRR UW HH HH IY M N AE
رحموت|RRR AE HH AE M UW T
رحى|RRR AE HH AE
رحيق|RRR AE HH IY K
رحيل|RRR AE HH IY L
رحيم|RRR AE HH IY M
رخ|RRR UW HH HH
رخاخ|RRR IY HH AE HH
رخام|RRR HH AE M
رخخة|RRR IY HH AE HH AE
رخيص|RRR AE HH IY S
رخيم|RRR AE HH IY M
رد|RRR IY D
رداء|RRR IY D AE Q
ردة|RRR IY D D AE
ردد|RRR AE D D AE D AE
ردع|RRR AE D AE RH AE
ردم|RRR AE D AE M AE
ردى|RRR AE D D AE
رذ|RRR AE DH DH AE
رذاذ|RRR AE DH AE DH
رزتاق|RRR UW Z T AE K
رزداق|RRR UW Z D AE K
رساطون|RRR UW S AE T UW N
رسالة|RRR IY S AE L AE
رستاق|RRR UW S T AE K
رسداق|RRR UW S D AE K
رسغ|RRR UW S HH
رسول|RRR AE S UW L
رشح|RRR AE SH SH AE HH AE
رشف|RRR AE SH AE F AE
رشفة|RRR AE SH F AE
رشيق|RRR AE SH IY K
رصاص|RRR AE S AE S
رصاصة|RRR AE S AE S AE
رصع|RRR AE S S AE RH AE
رصفاء|RRR UW S AE F AE Q
رصفان|RRR UW S F AE N
رضا|RRR IY D AE N
رضائع|RRR AE D AE Q IY RH
رضة|RRR AE D D AE
رضعاء|RRR UW D AE RH AE Q
رضوخ|RRR UW D UW HH
رضى|RRR UW D AE
رضيع|RRR AE D IY RH
رطانة|RRR IY T AE N AE
رطب|RRR UW T AE B
رطريط|RRR UW T RRR IY T
رطوبة|RRR UW T UW B AE
رعاية|RRR IY RH AE Y AE
رعد|RRR AE RH D
رعراع|RRR AE RH RRR AE RH
رعرع|RRR AE RH RRR AE RH AE
رعى|RRR AE RH AE
رغائف|RRR AE HH AE Q IY F
رغف|RRR UW HH UW F
رغفان|RRR UW HH F AE N
رغم|RRR AE HH M AE
رغوة|RRR AE HH W AE
رغيف|RRR AE HH IY F
رغيفات|RRR AE HH IY F AE T
رغيفة|RRR AE HH IY F AE
رف|RRR AE F F
رفأ|RRR AE F AE Q AE
رفائيل|RRR UW F AE Q IY L
رفاهة|RRR AE F AE HH AE
رفس|RRR AE F AE S AE
رفقة|RRR UW F K AE
رفيق|RRR AE F IY K
رقابة|RRR IY K AE B AE
رقبة|RRR AE G AE B AE
رقصة|RRR AE K S AE
رقف|RRR AE K AE F
رقم|RRR AH0 K AH0 M
رقيب|RRR AE K IY B
رقيق|RRR AE K IY K
ركبة|RRR UW K B AE
ركض|RRR AE K D
ركع|RRR AE K AE RH AE
ركف|RRR AE K AE F
ركل|RRR AE K L
ركلات|RRR AE K AE L AE T
ركلة|RRR AE K L AE
ركن|RRR UW K N
ركنية|RRR UW K N IY Y Y AE
ركيزة|RRR AE K IY Z AE
رم|RRR AE M M AE
رماد|RRR AE M AE D
رمادي|RRR AE M AE D IY Y Y
رمال|RRR IY M AE L
رمان|RRR UW M M AE N
رمرام|RRR AE M RRR AE M
رمرم|RRR AE M RRR AE M AE
رمس|RRR AE M AE S
رمش|RRR IY M SH
رمضان|RRR UW M D AE N
رمل|RRR AE M L
رمم|RRR AE M M AE M AE
رمى|RRR AE M AE
رمي|RRR AE M Y
رند|RRR AE N D
رنف|RRR AE N F
رهبانية|RRR AE HH B AE N IY Y Y AE
رهبوت|RRR AE HH AE B UW T
رهج|RRR AE HH D
رهط|RRR AE HH AE T AE
رهيب|RRR AE HH IY B
رهينة|RRR AE HH IY N AE
رواصير|RRR AE W AE S IY RRR
رواصيل|RRR AE W AE S IY L
رواق|RRR UW W AE K
رواقي|RRR IY W AE K IY Y Y
رواقية|RRR IY W AE K IY Y Y AE
روبوت|RRR OW0 B OW0 T
روبيان|RRR UW B IY Y AE N
روح|RRR UW HH
روحاني|RRR UW HH AE N IY Y Y
روس|RRR UW S
روسختج|RRR UW S AE HH T AE D
روسي|RRR UW S IY Y Y
روسيا|RRR UW S Y AE
روض|RRR AE W W AE D AE
رومانسي|RRR UW M AE N S IY Y Y
رومانيا|RRR UW M AE N IY Y AE
رومية|RRR UW M IY Y Y AE
رونق|RRR AE W N AE K
رياسة|RRR IY Y AE S AE
رياضة|RRR IY Y AE D AE
رياضي|RRR IY Y AE D IY Y Y
ريال|RRR IY Y AE L
ريباس|RRR IY B AE S
ريح|RRR IY HH AE
ريحان|RRR AE Y HH AE N
ريش|RRR IY SH
ريشة|RRR IY SH AE
ريصار|RRR IY S AE RRR
ريصال|RRR IY S AE L
ريفي|RRR IY F IY Y Y
ريمونتادا|RRR EH0 M OW0 N T AE D AE
ريوند|RRR IY W AE N D
ز|Z AE Y
زأر|Z AE Q AE RRR AE
زأم|Z AE Q AE M AE
زأمة|Z AE Q M AE
زؤام|Z UW Q AE M
زئر|Z AE Q IY RRR AE
زئم|Z AE Q IY M AE
زئير|Z AE Q IY RRR
زاؤوق|Z AE Q UW K
زائر|Z AE Q IY RRR
زائف|Z AE Q IY F
زاح|Z AE HH AE
زار|Z AE RRR AE
زاغ|Z AE HH AE
زامبيا|Z AE M B IY Y AE
زانية|Z AE N IY Y AE
زاوية|Z AE W IY Y AE
زاي|Z AE Y
زايلفون|Z AE Y L UW F UW N
زبدة|Z UW B D AE
زبرجد|Z AE B AE RRR D AE D
زبطانة|Z AE B AE T AE N AE
زبل|Z IY B L
زبيب|Z AE B IY B
زبيل|Z IY B B IY L
زجاجة|Z UW D AE D AE
زحافة|Z AE HH HH AE F AE
زحزح|Z AE HH Z AE HH AE
زحف|Z AE HH F
زحل|Z UW HH AE L
زحمة|Z AE HH M AE
زخ|Z AE HH HH AE
زخات|Z AE HH HH AE T
زخة|Z AE HH HH AE
زخرفة|Z AE HH RRR AE F AE
زراعة|Z IY RRR AE RH AE
زراعي|Z IY RRR AE RH IY Y Y
زرافة|Z UW RRR AE F AE
زراوند|Z AE RRR AE W AE N D
زربطانة|Z AE RRR B AE T AE N AE
زربية|Z UW RRR B IY Y Y AE
زرجون|Z AE RRR D UW N
زردخان|Z AE RRR D AE HH AE N
زردخاناة|Z AE RRR AE D HH AE N AE HH
زردخانة|Z AE RRR D AE HH AE N AE
زرزر|Z UW RRR Z UW RRR
زرشك|Z AE RRR RRR AE SH K
زرع|Z AE RRR RH
زرقطونا|Z AE RRR K AE T UW N AE
زرقون|Z AE RRR K UW N
زرنب|Z AE RRR N UW B
زريبة|Z AE RRR IY B AE
زعتر|Z AE RH T AE RRR
زعزع|Z AE RH Z AE RH AE
زعط|Z AE RH AE T AE
زعيم|Z AE RH IY M
زغاية|Z AE HH AE Y AE
زغرد|Z AE HH RRR AE D AE
زغلول|Z UW HH L UW L
زفر|Z AE F AE RRR AE
زفزف|Z IY F Z IY F
زفن|Z AE F AE N AE
زفيزف|Z UW F AE Y Z AE F
زق|Z UW K K
زقاق|Z UW K AE K
زقوم|Z AE K K UW M
زكاة|Z AH0 K AE T
زكام|Z UW K AE M
زكريا|Z AE K AE RRR IY Y Y AE
زكوة|Z AE K AE HH
زلية|Z UW L IY Y Y AE
زم|Z AE M M AE
زمام|Z IY M AE M
زمان|Z AE M AE N
زمانئذ|Z AE M AE N AE Q IY DH IY N
زمانذاك|Z AE M AE N AE DH AE K AE
زمج|Z UW M M AE D
زمجر|Z AE M D AE RRR AE
زمرة|Z UW M RRR AE
زمرد|Z UW M UW RRR RRR UW D
زمزريق|Z AE M Z AE RRR IY K
زمزم|Z AE M Z AE M AE
زمكان|Z AE M AE K AE N
زملاء|Z UW M AE L AE Q
زمن|Z AE M AE N
زمنئذ|Z AE M AE N AE Q IY DH IY N
زمنذاك|Z AE M AE N AE DH AE K AE
زميل|Z AE M IY L
زميلات|Z AE M IY L AE T
زميلة|Z AE M IY L AE
زنار|Z UW N N AE RRR
زنباع|Z AE N B AE RH
زنباعة|Z AE N B AE RH AE
زنبق|Z AE N B AE K
زنبوج|Z AE N B UW D
زنبور|Z UW N B UW RRR
زنبوع|Z AE N B UW RH
زنة|Z IY N AE
زنجبيل|Z AE N D AE B IY L
زنخ|Z AE N IY HH AE
زندقة|Z AE N D AE K AE
زنديق|Z IY N D IY K
زنزانة|Z IY N Z AE N AE
زنوبة|Z AE N N UW B AE
زها|Z AE HH AE
زهرة|Z UW HH RRR AE
زهرية|Z AE HH RRR IY Y Y AE
زهو|Z AE HH W
زواج|Z AE W AE D
زوال|Z AE W AE L
زوان|Z UW W W AE N
زوج|Z AE W W AE D AE
زوجة|Z OW0 D AE
زوجي|Z AE W D IY Y Y
زود|Z AE W W AE D AE
زوراء|Z AE W RRR AE Q
زورق|Z AE W RRR AE K
زوفا|Z UW F AE
زوفرا|Z AE W F AE RRR AE
زوقال|Z UW K AE L
زولية|Z UW L IY Y Y AE
زوم|Z UW M
زياد|Z IY Y AE D
زيار|Z IY Y AE RRR
زيارة|Z IY Y AE RRR AE
زيت|Z AE Y T
زيتي|Z AE Y T IY Y Y
زيزفون|Z AE Y Z AE F UW N
زينب|Z AE Y N AE B
س|S IY N
سؤال|S UW Q Q AE L
سؤدد|S UW Q D UW D
سئم|S AE Q IY M AE
ساء|S AE Q AE
ساءل|S AE Q AE L AE
سائبة|S AE Q IY B AE
سائح|S AE Q IY HH
سائمة|S AE Q IY M AE
سابع|S AE B IY RH
سابق|S AE B IY K
سابيائي|S AE B IY Y AE Q IY Y Y
ساج|S AE D
ساجور|S AE D UW RRR
ساحة|S AE HH AE
ساحل|S AE HH IY L
ساحلي|S AE HH IY L IY Y Y
ساخط|S AE HH IY T
ساخن|S AE HH IY N
ساد|S AE D AE
سادس|S AE D IY S
سادن|S AE D IY N
ساذج|S AE DH IY D
سار|S AE RRR RRR
ساسم|S AE S AE M
ساط|S AE T AE
ساع|S AE RH IY N
ساعة|S AE RH AE
ساعد|S AE RH IY D
ساف|S AE F
سافانا|S AE F AE N AE
ساق|S AE K AE
ساكف|S AE K IY F
سامور|S AE M UW RRR
ساند|S AE N AE D AE
ساندويتش|S AE N D W IY T SH
سانية|S AE N Y AE
ساهر|S AE HH AE RRR AE
ساهم|S AE HH AE M AE
ساهور|S AE HH UW RRR
ساوم|S AE W AE M AE
سبأ|S AE B AE Q
سبئي|S AE B AE Q IY Y Y
سباك|S AE B B AE K
سبب|S AE B B AE B AE
سبتمبر|S IY P T AE M B AE RRR
سبج|S AE B AE D
سبح|S AE B HH
سبخة|S AE B HH AE
سبسب|S AE B S AE B AE
سبطانة|S AE B AE T AE N AE
سبعة|S AE B RH AE
سبعون|S AE B RH UW N AE
سبلة|S AE B L AE
سبورة|S AE B B UW RRR AE
ستار|S IY T AE RRR
ستارة|S IY T AE RRR AE
ستة|S IY T T AE
ستون|S IY T T UW N AE
سجا|S AE D AE
سجادة|S IY D AE D AE
سجستان|S IY D IY S T AE N
سجلاط|S IY D IY L L AE T
سجنجل|S AE D AE N D AE L
سجين|S AE D IY N
سحاب|S AE HH AE B
سحابة|S AE HH AE B AE
سحلب|S AE HH L AE B
سحلية|S IY HH L IY Y Y AE
سحم|S AE HH HH AE M AE
سحور|S UW HH UW RRR
سخاء|S AE HH AE Q
سخاب|S IY HH AE B
سخام|S UW HH AE M
سخبر|S AE HH B AE RRR
سخد|S UW HH D
سخل|S AE HH L
سخيف|S AE HH IY F
سدارة|S AE D AE RRR AE
سدر|S IY D RRR
سدل|S AE D AE L AE
سذاب|S UW DH AE B
سذاجة|S AE DH AE D AE
سراة|S AE RRR AE HH
سراح|S AE RRR AE HH
سرادق|S UW RRR AE D IY K
سراط|S IY RRR AE T
سراق|S UW RRR RRR AE K
سراويل|S AE RRR AE W IY L
سربال|S IY RRR B AE L
سربام|S AE RRR AE B AE M
سرة|S UW RRR RRR AE
سرجين|S IY RRR D IY N
سرخس|S AE RRR HH AE S
سرد|S AE RRR D
سرداب|S IY RRR D AE B
سرط|S AE RRR AE T AE
سرقسطة|S AE RRR AE K UW S T AE
سرقين|S IY RRR K IY N
سركنجبين|S IY RRR K AE N D UW B IY N
سرمق|S AE RRR M AE K
سرنديب|S AE RRR AE N D IY B
سرو|S AE RRR W
سروال|S IY RRR W AE L
سرور|S UW RRR UW RRR
سرى|S AE RRR AE
سريان|S AE RRR AE Y AE N
سرير|S IH RRR IY RRR
سريش|S IY RRR IY SH
سريع|S AE RRR IY RH
سريلانكا|S IY RRR IY L AE N K AE
سطات|S IY T AE T
سطام|S IY T AE M
سطح|S AE T HH
سطع|S AE T AE RH AE
سطم|S AE T M
سطوة|S AE T W AE
سعادة|S AE RH AE D AE
سعار|S UW RH AE RRR
سعال|S UW RH AE L
سعة|S AE RH AE
سعد|S UW RH D
سعدان|S AE RH D AE N
سعل|S AE RH AE L AE
سعودي|S UW RH UW D IY Y Y
سعى|S AE RH AE
سعي|S UW RH IY Y AE
سعيد|S AE RH IY D
سفاح|S IY F AE HH
سفارة|S IY F AE RRR AE
سفافيد|S AE F AE F IY D
سفر|S IY F RRR
سفرة|S UW F RRR AE
سفرجل|S AE F AE RRR D AE L
سفرجلة|S AE F AE RRR D AE L AE
سفود|S AE F F UW D
سفوف|S AE F UW F
سفير|S AE F IY RRR
سفينة|S AH0 F IY N AH0
سفيه|S AE F IY HH
سقراط|S UW K RRR AE T
سقرلاط|S IY K IY RRR L AE T
سقطرة|S UW K UW T RRR AE
سقطرى|S UW K UW T RRR AE
سقف|S AE K F
سقلات|S IY K IY L L AE T
سقلاتون|S IY K IY L L AE T UW N
سقلاط|S IY K IY L L AE T
سقلاطون|S IY K IY L L AE T UW N
سقلطون|S IY K IY L L AE T UW N
سقلطوني|S IY K IY L L AE T UW N IY Y Y
سقم|S UW K M
سقمونيا|S AE K AE M UW N IY Y AE
سقنقور|S AE K AE N K UW RRR
سقيفة|S AE K IY F AE
سقيم|S AE K IY M
سكار|S UW K K AE RRR
سكافة|S IY K AE F AE
سكباج|S IY K B AE D
سكة|S IY K K AE
سكر|S UW K K AE RRR
سكران|S AE K RRR AE N
سكرتير|S IY K RRR IY T IY RRR
سكرجة|S UW K UW RRR RRR UW D AE
سكسكة|S AE K S AE K AE
سكن|S AE K K AE N AE
سكنجبين|S IY K AE N D UW B IY N
سكون|S UW K UW N
سكي|S AE K K IY Y Y
سكين|S IY K K IY N
سلا|S AE L AE
سلاح|S L AE HH
سلاطين|S AE L AE T IY N
سلاف|S UW L AE F
سلافي|S L AE F IY Y Y
سلالة|S UW L AE L AE
سلام|S IY L AE M
سلامة|S AE L AE M AE
سلامتك|S AE L AE M T IY K
سلباح|S IY L B AE HH
سلبي|S AE L B IY Y Y
سلة|S UW L L AE
سلجم|S AE L D AE M
سلجوق|S AE L D UW K
سلجوقي|S AE L D UW K IY
سلح|S AE L HH
سلحفاة|S UW L AE HH F AE HH
سلسل|S AE L S AE L AE
سلسلة|S IY L S IY L AE
سلطان|S UW L T AE N
سلطانية|S UW L T AE N IY Y Y AE
سلطة|S UW L T AE
سلطنة|S AE L T AE N AE
سلطوي|S UW L T AE W IY Y Y
سلطوية|S UW L T AE W IY Y Y AE
سلعة|S IY L RH AE
سلم|S UW L L AE M
سلماس|S AE L AE M AE S
سلوفاكيا|S L OW0 V AE K IY Y AE
سلوفينيا|S L OW0 V EH0 N IY Y AE
سلوى|S AE L W AE
سليخة|S AE L IY HH AE
سليقة|S AE L IY K AE
سليل|S AE L IY L
سليلة|S AE L IY L AE
سليلى|S UW L AE Y L AE
سليمان|S UW L AE Y M AE N
سماء|S AE M AE Q
سماد|S AE M AE D
سمار|S AE M AE RRR
سماوي|S AE M AE W IY Y Y
سمبوسة|S AE M B UW S AE
سمبوسك|S AE M B UW S AE K
سمرقند|S AE M AE RRR K AE N D
سمع|S AE M RH
سمعي|S AE M RH IY Y Y
سمك|S AE M AE K
سمكة|S AE M AE K AE
سمن|S UW M N AE
سمو|S UW M UW W W
سموأل|S AE M AE W Q AE L
سموئيل|S AE M AE W Q IY L
سمور|S AE M M UW RRR
سموم|S UW M UW M
سمويل|S AE M AE W IY L
سمى|S AE M M AE
سميت|S AE M IY T
سميد|S AE M IY D
سميذ|S AE M IY DH
سميط|S AE M IY T
سميع|S AE M IY RH
سميك|S AE M IY K
سن|S IY N N
سنام|S AE N AE M
سنان|S IY N AE N
سنبك|S UW M B UW K
سنبل|S UW N B UW L
سنبلة|S UW N B UW L AE
سنبوسة|S AE M B UW S AE
سنبوسج|S AE M B UW S AE D
سنبوسق|S AE M B UW S AE K
سنبوسك|S AE M B UW S AE K
سنة|S UW N N AE
سنت|S UW N N AE T
سنجاب|S IY N D AE B
سنجق|S AE N D AE K
سندس|S UW N D UW S
سنط|S AE N T
سنغافورة|S IY N HH AE F UW RRR AE
سنوت|S AE N N UW T
سنور|S IY N N AE W RRR
سنونو|S UW N UW N UW
سنونوة|S UW N UW N UW W AE
سنونية|S UW N UW N IY Y AE
سني|S UW N N IY Y Y
سهر|S AE HH IY RRR AE
سهل|S AE HH UW L AE
سهلا|S AE HH L AE N
سهم|S AE HH M
سهوة|S AE HH W AE
سهول|S UW HH UW L
سوء|S UW Q
سوار|S IY W AE RRR
سواكن|S AE W AE K IY N
سوراني|S UW RRR AE N IY Y Y
سورة|S UW RRR AE HH
سورنجان|S UW RRR IY N D AE N
سوريا|S UW RRR IY Y Y AE
سورينام|S UW RRR IY N AE M
سوس|S UW S
سوسة|S UW S AE
سوط|S AE W T
سوفياتي|S UW F Y AE T IY Y Y
سوق|S UW Q
سونكي|S UW N K IY Y Y
سويداء|S UW W AE Y D AE Q
سويدي|S UW W AE Y D IY Y Y
سويسرا|S W IY S RRR AE
سويسري|S W IY S RRR IY Y Y
سيء|S IY Q AE
سيئ|S AE Y Y IY Q
سياج|S IY Y AE D
سيادة|S IY Y AE D AE
سيارة|S AH0 Y Y AA RRR AH0
سياسة|S IY Y AE S AE
سياع|S IY Y AE RH
سيبويه|S IY B AE W AE Y HH IY
سيجارة|S IY G AE RRR AE
سيخ|S IY HH
سيخي|S IY HH IY Y Y
سيخية|S IY HH IY Y Y AE
سيد|S AE Y Y IY D
سيدا|S IY D AE
سيراء|S IY RRR AE Q
سيراليون|S IY RRR AE L IY Y UW N
سيرج|S IY RRR IY D
سيرك|S IY RRR K
سيس|S AE Y Y AE S AE
سيسبان|S AE Y S AE B AE N
سيطر|S AE Y T AE RRR AE
سيطرة|S AE Y T AE RRR AE
سيف|S IY F
سيكران|S AE Y K UW RRR AE N
سيكولوجي|S AE Y K UW L UW D IY Y Y
سيل|S AE Y L
سيماء|S IY M AE Q
سين|S IY N
سيناء|S AE Y N AE Q
سينثيا|S IY N TH IY Y AE
سينما|S IY N AE M AE
سينمائي|S IY Y N AE M AE Q IY Y Y
ش|SH IY N
شؤبوب|SH UW Q B UW B
شؤم|SH UW Q M
شاء|SH AE Q AE
شاب|SH AE B B
شابانج|SH AE B AE N AE D
شابانك|SH AE B AE N AE K
شاة|SH AE HH
شاحن|SH AE HH IY N
شاخ|SH AE HH AE
شاذ|SH AE DH DH
شار|SH AE RRR IY N
شارع|SH AE RRR IY RH
شاسع|SH AE S IY RH
شاشة|SH AE SH AE
شاشية|SH AE SH IY Y Y AE
شاط|SH AE T AE
شاطئ|SH AE T IY Q
شاع|SH AE RH AE
شاعري|SH AE RH IY RRR IY Y Y
شاف|SH AE F AE
شافانج|SH AE F AE N AE D
شافعي|SH AE F IY RH IY Y Y
شاقول|SH AE K UW L
شاقولي|SH AE K UW L IY Y Y
شاكر|SH AE K IY RRR
شاكرة|SH AE K IY RRR AE
شاكوش|SH AE K UW SH
شام|SH AE M AE
شامبو|SH AE M B UW
شامة|SH AE M AE
شامخ|SH AE M IY HH
شاهبلوط|SH AE HH B AE L L UW T
شاهترج|SH AE HH T AE RRR AE D
شاهد|SH AE HH AE D AE
شاهدانج|SH AE HH D AE N AE D
شاهدانق|SH AE HH D AE N AE K
شاهل|SH AE HH AE L AE
شاهلوج|SH AE HH AE L UW D
شاهلوك|SH AE HH AE L UW K
شاهنشاه|SH AE HH AE N SH AE HH
شاور|SH AE W AE RRR AE
شاورما|SH AA W AH0 RRR M AH0
شاي|SH AE Y
شب|SH AE B B AE
شبابة|SH AE B B AE B AE
شبح|SH UW B IY HH AE
شبرم|SH AE B RRR AE M
شبشب|SH IY B SH IY B
شبع|SH AE B IY RH AE
شبعان|SH AE B RH AE N
شبقي|SH AE B AE K IY Y Y
شبكة|SH AE B AE K AE
شبهة|SH UW B HH AE
شبوط|SH AE B B UW T
شبوطة|SH AE B B UW T AE
شبيه|SH AE B IY HH
شتاء|SH IY T AE Q
شتم|SH AE T AE M AE
شتوة|SH AE T W AE
شتيمة|SH AE T IY M AE
شج|SH AE D IY N
شجا|SH AE D AE
شجاع|SH UW D AE RH
شجرة|SH AE ZH RRR AE
شجو|SH AE D W
شجيرة|SH UW D AE Y RRR AE
شجيع|SH AE D IY RH
شحاذ|SH AE HH HH AE DH
شحاذة|SH IY HH AE DH AE
شحرور|SH UW HH RRR UW RRR
شحن|SH AE HH AE N AE
شحيح|SH AE HH IY HH
شحيرة|SH AE HH IY RRR AE
شخر|SH AE HH HH AE RRR AE
شخشخ|SH AE HH SH AE HH AE
شخشيخة|SH UW HH SH IY HH AE
شخص|SH AE HH HH AE S AE
شخصيا|SH AE HH S IY Y Y AE N
شد|SH AE D D AE
شدا|SH AE D AE
شدة|SH IY D D AE
شدد|SH AE D D AE D AE
شدياق|SH IY D Y AE K
شذر|SH AE DH DH AE RRR AE
شراء|SH IY RRR AE Q
شراب|SH UW RRR RRR AE B
شراع|SH IY RRR AE RH
شرب|SH UW RRR B
شربة|SH AE RRR B AE
شربوش|SH AE RRR B UW SH
شرحي|SH AE RRR HH IY Y Y
شرد|SH AE RRR AE D AE
شرسوف|SH UW RRR S UW F
شرش|SH UW RRR SH
شرشرة|SH AE RRR SH AE RRR AE
شرشيري|SH AE RRR SH IY RRR IY Y Y
شرطة|SH UW RRR T AE
شرعي|SH AE RRR RH IY Y Y
شرعية|SH AE RRR RH IY Y Y AE
شرق|SH AE RRR K
شرقي|SH AE RRR K IY Y Y
شركة|SH AA RRR IH K AH0
شرموطة|SH AE RRR M UW T AE
شره|SH AE RRR IY HH AE
شريان|SH IY RRR Y AE N
شريش|SH IY RRR IY SH
شريطة|SH AE RRR IY T AE
شريعة|SH AE RRR IY RH AE
شريك|SH AE RRR IY K
شطر|SH AE T RRR
شظية|SH AE DH IY Y Y AE
شعاع|SH UW RH AE RH
شعب|SH UW RH AE B
شعبة|SH UW RH B AE
شعبي|SH AE RH B IY Y Y
شعبية|SH AE RH B IY Y Y AE
شعر|SH UW RH UW RRR
شعرى|SH AE RH RRR AE
شعري|SH IY RH RRR IY Y Y
شعلة|SH UW RH L AE
شعيب|SH UW RH AE Y B
شعير|SH AE RH IY RRR
شغاف|SH UW HH AE F
شفاف|SH AE F F AE F
شفة|SH AE F AE
شفر|SH AE F RRR
شفنين|SH IY F N IY N
شفى|SH AE F AE
شق|SH IY K K
شقاء|SH AE K AE Q
شقة|SH UW K K AE
شقف|SH AE K F
شقواص|SH AE K W AE S
شقوة|SH AE K W AE
شقي|SH AE K IY Y Y
شك|SH AE K K
شكارة|SH IY K AE RRR AE
شكال|SH IY K AE L
شكرا|SH UW K RRR AE N
شكري|SH UW K RRR IY Y Y
شكوس|SH AE K W AE S
شكوش|SH AE K UW SH
شكوهج|SH IY K UW HH AE D
شلاق|SH AE L L AE K
شلال|SH AE L L AE L
شلباية|SH IY L B AE Y AE
شلبة|SH IY L B AE
شلة|SH IY L L AE
شلجم|SH AE L D AE M
شلح|SH AE L AE HH AE
شلغم|SH AE L HH AE M
شلكاية|SH AE L AE K AE Y AE
شلنبر|SH UW L UW N B AE RRR
شلنج|SH AE L AE N G
شلوق|SH UW L UW K
شليل|SH AE L IY L
شم|SH AE M M AE
شمات|SH AE M AE T
شماتة|SH AE M AE T AE
شماس|SH IY M AE S
شمال|SH IY M AE L
شمالي|SH AE M AE L IY Y Y
شمام|SH AE M M AE M
شمبانيا|SH AE M P AE N Y AE
شمراخ|SH IY M RRR AE HH
شمروخ|SH UW M RRR UW HH
شمس|SH AE M S
شمسي|SH AE M S IY Y Y
شمسية|SH AE M S IY Y Y AE
شمشاد|SH AE M SH AE D
شمشار|SH AE M SH AE RRR
شمشم|SH AE M SH AE M AE
شمشير|SH AE M SH IY RRR
شمع|SH AE M RH
شمعة|SH AE M RH AE
شمندورة|SH AE M AE N D UW RRR AE
شموئيل|SH AE M AE W Q IY L
شموخ|SH UW M UW HH
شمويل|SH AE M AE W IY L
شن|SH AE N N AE
شنبر|SH AE N B AE RRR
شنجار|SH IY N D AE RRR
شنداب|SH IY N D AE B
شندقورة|SH AE N D G UW RRR AE
شنع|SH AE N UW RH AE
شنيع|SH AE N IY RH
شهاب|SH IY HH AE B
شهادة|SH AE HH AE D AE
شهباء|SH AE HH B AE Q
شهترج|SH AE HH T AE RRR AE D
شهدانج|SH AE HH D AE N AE D
شهدانق|SH AE HH D AE N AE K
شهر|SH AE HH RRR
شهق|SH AE HH AE K AE
شهل|SH UW HH L
شهلاء|SH AE HH L AE Q
شهلة|SH UW HH L AE
شهواني|SH AE HH W AE N IY Y Y
شهوة|SH AE HH W AE
شوب|SH AE W B
شوبك|SH AE W B AE K
شوح|SH UW HH
شوحة|SH UW HH AE
شوفان|SH UW F AE N
شوكة|SH AE W K AE
شوكران|SH AE W K AE RRR AE N
شوكولاتة|SH UW K UW L AE T AE
شوكي|SH AE W K IY Y Y
شونة|SH UW N AE
شونيز|SH UW N IY Z
شوهاء|SH AE W HH AE Q
شوى|SH AE W AE
شي|SH AE Y Y
شيء|SH IY Q AE
شياف|SH IY Y AE F
شيباء|SH AE Y B AE Q
شيح|SH IY HH
شيخ|SH EH0 HH
شيخوخة|SH AE Y HH UW HH AE
شيراز|SH IY RRR AE Z
شيرة|SH AE Y RRR AE
شيرج|SH IY RRR IY D
شيردال|SH IY RRR D AE L
شيرون|SH AE Y RRR UW N
شيرى|SH AE Y RRR AE
شيزى|SH IY Z AE
شيص|SH IY S
شيطان|SH AE Y T AE N
شيطاني|SH AE Y T AE N IY Y Y
شيطانية|SH AE Y T AE N IY Y Y AE
شيطن|SH AE Y T AE N AE
شيعة|SH IY RH AE
شيك|SH IY K
شيلثا|SH IY L TH AE
شيلم|SH AE Y L AE M
شيم|SH IY M
شيمة|SH IY M AE
شين|SH IY N
شيهم|SH AE Y HH AE M
ص|S AE D
صأصأ|S AE Q S AE Q AE
صأكة|S AE Q K AE
صأل|S AE Q AE L AE
صأم|S AE Q AE M AE
صأى|S AE Q AE
صؤاب|S UW Q AE B
صؤابة|S UW Q AE B AE
صؤل|S AE Q UW L AE
صؤول|S AE Q UW L
صئب|S AE Q IY B AE
صئك|S AE Q IY K UW N
صئم|S AE Q IY M AE
صاءك|S AE Q AE K AE
صائب|S AE Q IY B
صائغ|S AE Q IY HH
صابح|S AE B IY HH
صابورة|S AE B UW RRR AE
صات|S AE T AE T AE
صاج|S AE D
صاحب|S AE HH IY B
صاخب|S AE HH IY B
صاخة|S AE HH HH AE
صاد|S AE D AE
صادف|S AE D AE F AE
صارخ|S AA RRR IY HH
صاروج|S AE RRR UW D
صاع|S AE RH
صاغ|S AE HH AE
صاقور|S AE K UW RRR
صالح|S AE L IY HH
صبابة|S UW B AE B AE
صبان|S AE B B AE N
صبة|S UW B B AE
صبث|S AE B AE TH AE
صبحة|S UW B HH AE
صبر|S AE B RRR
صبرة|S UW B RRR AE
صبصب|S AE B S AE B AE
صبع|S AE B AE RH
صبن|S AE B AE N AE
صبي|S UW B B IY
صبيب|S AE B IY Y B
صت|S IY T T
صتأ|S AE T AE Q AE
صتع|S AE T AE RH AE
صتم|S AE T T AE M AE
صتيت|S AE T IY T
صج|S AE D D AE
صحا|S AE HH AE
صحاف|S AE HH HH AE F
صحافة|S IY HH AE F AE
صحافي|S IY HH AE F IY Y Y
صحة|S IY HH HH AE
صحح|S AE HH HH AE HH AE
صحر|S AE HH IY RRR AE
صحراء|S AE HH RRR AE Q
صحراوي|S AE HH RRR AE W IY Y Y
صحرة|S UW HH RRR AE
صحصح|S AE HH S AE HH
صحفة|S AE HH F AE
صحفي|S UW HH UW F IY Y Y
صحل|S AE HH IY L AE
صحمة|S UW HH M AE
صحن|S AE HH AE N AE
صحوة|S AE HH W AE
صحى|S AE HH HH AE
صحي|S IY HH HH IY Y Y
صحيح|S AE HH IY HH
صحيفة|S AE HH IY F AE
صخ|S AE HH HH AE
صخة|S AE HH HH AE
صخد|S AE HH AE D AE
صخدان|S AE HH D AE N
صخف|S AE HH AE F AE
صخم|S AE HH AE M AE
صخيد|S AE HH IY D
صدؤ|S AE D UW Q AE
صداقة|S AE D AE K AE
صدر|S AE D RRR
صدرية|S UW D RRR IY Y Y AE
صدغ|S UW D HH
صدفة|S UW D F AE
صدق|S UW D UW K
صدقة|S AE D AE K AE
صدم|S AE D AE M AE
صديق|S IY D D IY K
صراخة|S AE RRR RRR AE HH AE
صراط|S IY RRR AE T
صراع|S IY RRR AE RH
صرافة|S IY RRR AE F AE
صرب|S AE RRR AE B AE
صربي|S IY RRR B IY Y Y
صربيا|S IY RRR B IY Y AE
صرج|S AE RRR RRR AE D AE
صرصار|S IY RRR S AE RRR
صرق|S AE RRR AE K
صريقة|S AE RRR IY K AE
صطم|S AE T AE M AE
صعب|S AE RH RH AE B AE
صعتر|S AE RH T AE RRR
صعلوك|S UW RH L UW K
صعوبة|S UW RH UW B AE
صعيد|S AE RH IY D
صغار|S UW HH AE RRR
صغر|S IY HH AE RRR
صغير|S AE HH IY RRR
صف|S AE F F
صفا|S AE F AE
صفارة|S AE F F AE RRR AE
صفة|S UW F F AE
صفحة|S AE F HH AE
صفد|S AE F F AE D AE
صفر|S IY F RRR
صفصاف|S AE F S AE F
صفع|S AE F AE RH AE
صفعة|S AE F RH AE
صفن|S AE F AE N
صفيحة|S AE F IY HH AE
صفيراء|S UW F AE Y RRR AE Q
صقاع|S IY K AE RH
صقر|S AE K RRR
صقنقور|S AE K AE N K UW RRR
صقيع|S AE K IY RH
صك|S AE K K AE
صلابة|S AE L AE B AE
صلاة|S AE L AE HH
صلصال|S AE L S AE L
صلعة|S UW L RH AE
صلعمي|S AE L RH AE M IY Y Y
صلوة|S AE L AE HH
صلى|S AE L L AE
صمام|S IY M AE M
صمغ|S AE M HH
صمم|S AE M M AE M AE
صناب|S IY N AE B
صنار|S IY N AE RRR
صنارة|S IY N N AE RRR AE
صنان|S UW N AE N
صنبور|S UW N B UW RRR
صنج|S AE N D
صندوق|S AH0 N D UW G
صنع|S UW N RH
صنعاء|S AE N RH AE Q
صنعة|S AE N RH AE
صنوبر|S UW N OW0 B AE RRR
صهب|S AE HH IY B AE
صهريج|S IY HH RRR IY D
صهيون|S UW HH Y UW N
صهيوني|S UW HH Y UW N IY Y Y
صهيونية|S UW HH Y UW N IY Y Y AE
صواب|S AE W AE B
صواع|S UW W AE RH
صوب|S AE W W AE B AE
صوة|S UW W W AE
صوت|S AE W T
صودا|S OW0 D AE
صورة|S UW RRR AE
صوف|S UW F
صوفي|S UW F IY Y Y
صولجان|S AE W L AE D AE N
صوم|S AE W M
صومعة|S AE W M AE RH AE
صياد|S AE Y Y AE D
صيخد|S AE Y HH AE D
صيخود|S AE Y HH UW D
صيد|S AE Y D
صيدلاني|S AE Y D AE L AE N IY Y Y
صيدلة|S AE Y D AE L AE
صيدلي|S AE Y D AE L IY Y Y
صيدلية|S AE Y D AE L IY Y Y AE
صيصية|S IY S IY Y AE
صيف|S AE Y F
صيفة|S AE Y F AE
صيقل|S AE Y K AE L
صيني|S IY N IY Y Y
صيهب|S AE Y HH AE B
ض|
ضأن|D AE Q N
ضائن|D AE Q IY N
ضائنة|D AE Q IY N AE
ضاجع|D AE D AE RH AE
ضاحك|D AE HH IY K
ضاحية|D AE HH IY Y AE
ضاد|D AE D D AE
ضاع|D AE RH AE
ضال|D AE L L
ضالا|D AE L L AE N
ضالين|D AE L L IY N
ضايق|D AE Y AE K AE
ضب|D AE B B
ضباب|D IY B AE B
ضبط|D AE B AE T AE
ضجة|D AE D D AE
ضجر|D AE D IY RRR
ضجع|D AE D AE RH AE
ضجيج|D AE D IY D
ضحك|D IY HH K
ضحية|D AE HH IY Y Y AE
ضخم|D AE HH HH AE M AE
ضد|D IY D D AE
ضرب|D UW RRR IY B AE
ضربة|D AE RRR B AE
ضرة|D AE RRR RRR AE
ضرط|D AE RRR T
ضريبة|D AE RRR IY B AE
ضريح|D AE RRR IY HH
ضرير|D AE RRR IY RRR
ضعيف|D AE RH IY F
ضغبوس|D UW HH B UW S
ضفة|D IY F F AE
ضفدع|DH AH0 F D AE RH
ضل|D AE L L AE
ضمان|D AE M AE N
ضمة|D AE M M AE
ضمخ|D AE M AE HH AE
ضمران|D AE M RRR AE N
ضمن|D IY M N AE
ضمني|D IY M N IY Y Y
ضمور|D UW M UW RRR
ضمير|D AE M IY RRR
ضوء|D AE W Q
ضوأ|D AE W W AE Q AE
ضواحك|D AE W AE HH IY K
ضواحي|D AE W AE HH IY
ضوضاء|D AE W D AE Q
ضوى|D AE W AE
ضياع|D AE Y AE RH
ضيع|D AE Y Y AE RH AE
ضيعة|D AE Y RH AE
ضيق|D IY K
ضيون|D AE Y W AE N
ط|T AE Q
طأطأ|T AE Q T AE Q AE
طاء|T AE Q
طائر|T AE Q IY RRR
طائرة|T AE Q IY RRR AE
طائفة|T AE Q IY F AE
طابعة|T AE B RH AH0
طابق|T AE B AE K
طابور|T AE B UW RRR
طاجن|T AE D IY N
طاجيكستان|T AE D IY K IY S T AE N
طاح|T AE HH AE
طار|T AE RRR AE
طارق|T AE RRR IY K
طاش|T AE SH AE
طاعة|T AE RH AE
طاعم|T AE RH AE M AE
طاعون|T AE RH UW N
طاغ|T AE HH IY N
طاغوت|T AE HH UW T
طاف|T AE F AE
طاق|T AE K AE
طاقة|T AE K AE
طاقم|T AE K IY M
طاقية|T AE G IY Y AE
طالب|T AE L IY B
طالم|T AE L AE M
طالما|T AE L AE M AE
طاولة|T AE W IY L AE
طب|T IY B
طباخ|T AE B B AE HH
طباق|T UW B B AE K
طبخ|T AE B HH
طبخة|T AE B HH AE
طبشورة|T AE B SH UW RRR AE
طبعة|T AE B RH AE
طبقات|T AE B AE K AE T
طبقة|T AE B AE K AE
طبي|T IY B B IY Y Y
طبيب|T AE B IY B
طبيبات|T AE B IY B AE T
طبيبة|T AE B IY B AE
طبيقة|T AE B IY K AE
طحال|T IY HH AE L
طحلب|T UW HH L UW B
طحن|T IY HH N
طحين|T AE HH IY N
طخش|T AE HH SH
طرأ|T AE RRR AE Q AE
طرا|T UW RRR RRR AE N
طرابلس|T AE RRR AE B UW L UW S
طراح|T IY RRR AE HH
طراز|T IY RRR AE Z
طربوش|T AE RRR B UW SH
طرخشقون|T AE RRR HH AE SH K UW N
طرخون|T AE RRR HH UW N
طرز|T AE RRR RRR AE Z AE
طرشي|T UW RRR SH IY Y Y
طرطور|T UW RRR T UW RRR
طرفاء|T UW RRR AE F AE Q
طرفة|T UW RRR F AE
طرق|T UW RRR UW K
طرمبة|T UW RRR UW M B AE
طريخ|T IY RRR RRR IY HH
طريق|T AE RRR IY K
طريقة|T AE RRR IY K AE
طشقند|T AE SH K AE N D
طعام|T AE RH AE M
طعن|T UW RH N AE
طفل|T IY F L
طفولة|T UW F UW L AE
طفيف|T AE F IY F
طقس|T AE K S
طقطق|T AE K T AE K AE
طقم|T AE K M
طل|T UW L
طلا|T AE L AE N
طلاق|T L AE K
طلب|T AE L AE B AE
طلح|T AE L HH
طلع|T AE L IY RH AE
طلعة|T AE L RH AE
طلمبة|T UW L UW M B AE
طليعة|T AE L IY RH AE
طمأن|T AE M Q AE N AE
طمأنينة|T UW M AE Q N IY N AE
طما|T AE M AE
طمث|T AE M TH
طمرة|T UW M M AE RRR AE
طموح|T UW M UW HH
طموحات|T UW M UW HH AE T
طمى|T AE M AE
طمي|T AE M Y
طنبور|T UW N B UW RRR
طنجة|T AE N D AE
طنجر|T AE N D AE RRR
طنجرة|T AE N D AE RRR AE
طنجير|T IY N D IY RRR
طنجيرة|T IY N D IY RRR AE
طنطور|T AE N T UW RRR
طه|T AE HH AE
طهران|T AE HH RRR AE N
طواجن|T AE W AE D IY N
طوارئ|T AE W AE RRR IY Q
طوافة|T AE W W AE F AE
طوب|T UW B
طوبة|T UW B AE
طود|T AE W D
طوعا|T AE W RH AE N
طوفان|T UW F AE N
طوكيو|T UW K IY Y UW
طول|T UW L
طومار|T UW M AE RRR
طويل|T AE W IY L
طي|T AE Y Y
طيارة|T IY Y Y AE RRR AE
طير|T IY RRR AE
طيرة|T AE Y RRR AE
طيفور|T IY F UW RRR
طيفورية|T AE Y F UW RRR IY Y Y AE
طيلة|T IY L AE T AE
طيلسان|T AE Y L IY S AE N
طين|T IY N
طيهوج|T IY HH UW D
طيون|T AE Y Y UW N
ظ|DH AE Q
ظاء|DH AE Q
ظالم|DH AE L IY M
ظاهري|DH AE HH IY RRR IY Y Y
ظبي|DH AE B Y
ظرافة|DH AE RRR AE F AE
ظربان|DH AE RRR IY B AE N
ظرفية|DH AE RRR F IY Y Y AE
ظفر|DH UW F UW RRR
ظلف|DH IY L F
ظليم|DH AE L IY M
ظمئ|DH AE M IY Q AE
ظن|DH AE N N AE
ظهر|DH UW HH RRR
ظيان|DH AE Y Y AE N
ع|RH AE Y N
عائشة|RH AE Q IY SH AE
عائلة|RH AE Q IY L AE
عاب|RH AE B AE
عابر|RH AE B IY RRR
عابس|RH AE B IY S
عاد|RH AE D AE
عادات|RH AE D AE T
عادة|RH AE D AE T AE N
عادم|RH AE D IY M
عار|RH AE RRR IY N
عازب|RH AE Z IY B
عاش|RH AE SH AE
عاشب|RH AE SH IY B
عاشر|RH AE SH IY RRR
عاشق|RH AE SH IY K
عاشوراء|RH AE SH UW RRR AE Q
عاصف|RH AE S IY F
عاصمة|RH AE S IY M AE
عاطف|RH AE T IY F
عاطفة|RH AE T IY F AE
عاطفي|RH AE T IY F IY Y Y
عافية|RH AE F IY Y AE
عاقبة|RH AE K IY B AE
عال|RH AE L IY N
عالمي|RH AE L AE M IY Y Y
عالي|RH AE L IY
عام|RH AE M M
عامل|RH AE M IY L
عانس|RH AE N IY S
عانق|RH AE N AE K AE
عانى|RH AE N AE
عاهل|RH AE HH IY L
عاين|RH AE Y AE N AE
عبء|RH IY B Q
عبأ|RH AE B B AE Q AE
عباء|RH AE B AE Q
عباءة|RH AE B AE Q AE
عبادة|RH IY B AE D AE
عبارة|RH IY B AE RRR AE
عباية|RH AE B AE Y AE
عبثران|RH AE B TH AE RRR AE N
عبد|RH AE B D
عبرة|RH IY B RRR AE
عبق|RH AE B IY K AE
عبقري|RH AH0 B K AH0 RRR IY
عبو|RH AE B W
عبوة|RH UW B UW W W AE
عبوثران|RH UW B AE W TH AE RRR AE N
عبودية|RH UW B UW D IY Y Y AE
عبيثران|RH UW B AE Y TH AE RRR AE N
عتاب|RH IY T AE B
عتب|RH AE T AE B AE
عتبات|RH AE T AE B AE T
عتبة|RH AE T AE B AE
عتل|RH AE T AE L AE
عتمة|RH AE T AE M AE
عتيرة|RH AE T IY RRR AE
عتيق|RH AE T IY K
عثة|RH UW TH TH AE
عثمان|RH UW TH M AE N
عثور|RH UW TH UW RRR
عج|RH AE D D AE
عجاب|RH UW D AE B
عجاج|RH AE D AE D
عجان|RH IY D AE N
عجاوة|RH UW D AE W AE
عجب|RH UW D B
عجج|RH AE D D AE D AE
عجرفة|RH AE D RRR AE F AE
عجرم|RH UW D RRR UW M
عجلة|RH IY D AE L AE
عجور|RH AE D D UW RRR
عجورة|RH AE D D UW RRR AE
عجوز|RH UW D UW Z
عجول|RH UW D UW L
عجيب|RH AE D IY B
عداء|RH IY D AE Q
عدالة|RH AE D AE L AE
عدان|RH IY D D AE N
عداوة|RH AE D AE W AE
عدد|RH AE D D AE D AE
عدمية|RH AE D AE M IY Y Y AE
عدنان|RH AE D N AE N
عدو|RH AE D UW W W
عدوان|RH UW D W AE N
عراء|RH AE RRR AE Q
عراك|RH IY RRR AE K
عران|RH IY RRR AE N
عربة|RH AE RRR AE B AE
عربز|RH AE RRR B AE Z
عربن|RH AE RRR B AE N AE
عربي|RH AE RRR AE B IY
عربية|RH AE RRR AE B IY Y Y AE
عربيزي|RH AE RRR AE B IY Z IY Y Y
عرزال|RH IY RRR Z AE L
عرطنيثا|RH AE RRR T AE N IY TH AE
عرعر|RH AE RRR RH AE RRR
عرف|RH UW RRR F
عرفي|RH UW RRR F IY Y Y
عرقوب|RH UW RRR K UW B
عرقي|RH IY RRR K IY Y Y
عرمس|RH IY RRR M IY S
عرمض|RH AE RRR M AE D
عرناس|RH IY RRR N AE S
عرنسية|RH AE RRR AE N S IY Y Y AE
عرنين|RH IY RRR N IY N
عروس|RH AE RRR UW S
عري|RH UW RRR Y
عريان|RH UW RRR Y AE N
عريش|RH AE RRR IY SH
عريض|RH AE RRR IY D
عرين|RH AE RRR IY N
عز|RH AE Z Z AE
عزا|RH AE Z AE
عزب|RH AE Z AE B AE
عزى|RH AE Z Z AE
عزيز|RH AE Z IY Z
عزيمة|RH AE Z IY M AE
عسال|RH AE S S AE L
عسبق|RH AE S B IY K
عسجد|RH AE S D AE D
عسقلان|RH AE S K AE L AE N
عسكر|RH AE S K AE RRR
عشاء|RH IY SH AE Q
عشب|RH UW SH B
عشرات|RH AE SH AE RRR AE T
عشرة|RH AE SH AE RRR AE
عشرون|RH IY SH RRR UW N
عشش|RH AE SH SH AE SH AE
عشية|RH AE SH IY Y Y AE
عشيرة|RH AE SH IY RRR AE
عصا|RH AE S AE
عصب|RH AE S S AE B AE
عصرن|RH AE S RRR AE N AE
عصعص|RH UW S RH UW S
عصف|RH AE S F
عصفور|RH UW S F UW RRR
عصمة|RH IY S M AE
عصيان|RH IY S Y AE N
عصيب|RH AE S IY B
عصير|RH AE S IY RRR
عض|RH UW D D
عضلة|RH AE D AE L AE
عضوي|RH UW D W IY Y Y
عضوية|RH UW D W IY Y Y AE
عط|RH AE T T
عطاء|RH AE T AE Q
عطار|RH AE T T AE RRR
عطارد|RH UW T AE RRR IY D
عطاس|RH UW T AE S
عطاط|RH AE T AE T
عطب|RH AE T IY B AE
عطر|RH IY T RRR
عطس|RH AE T AE S AE
عطف|RH AE T AE F AE
عطلة|RH UW T L AE
عطن|RH AE T T AE N AE
عظ|RH IY DH
عظم|RH UW DH M
عظمى|RH UW DH M AE
عظيم|RH AE DH IY M
عفت|RH AE F AE T AE
عفريت|RH IY F RRR IY T
عفو|RH AE F W
عفوا|RH AE F W AE N
عفونة|RH UW F UW N AE
عفوي|RH AE F W IY Y Y
عفيف|RH AE F IY F
عقاري|RH AE K AE RRR IY Y Y
عقاقير|RH AE K AE K IY RRR
عقال|RH UW K K AE L
عقب|RH AE K IY B AE
عقدة|RH UW K D AE
عقرب|RH AE G RRR AE B
عقل|RH AE K L
عقلن|RH AE K L AE N AE
عقيدة|RH AE K IY D AE
عقيق|RH AE K IY K
عكاز|RH UW K K AE Z
عكازة|RH UW K K AE Z AE
عكر|RH IY K RRR
عل|RH AE L L AE
علا|RH AE L AE
علاجي|RH IY L AE D IY
علامة|RH AE L AE M AE
علة|RH IY L L AE
علج|RH IY L D
علس|RH AE L AE S
علقة|RH AE L AE K AE
علقم|RH AE L K AE M
علل|RH AE L L AE L AE
علم|RH IY L M
علني|RH AE L AE N IY Y Y
على|RH UW L AE N
علي|RH UW L IY Y AE
عليق|RH UW L L AE Y K
عليل|RH AE L IY L
عليم|RH AE L IY M
عليون|RH IY L L IY Y Y UW N
عم|RH AE M M
عما|RH AE M M AE
عماد|RH IY M AE D
عمامة|RH IY M AE M AE
عمان|RH UW M AE N
عمة|RH IY M M AE
عمدة|RH UW M D AE
عمرة|RH UW M RRR AE
عمرو|RH AE M RRR
عمروسة|RH AE M RRR UW S AE
عمل|RH AE M M AE L AE
عمم|RH AE M M AE M AE
عمن|RH AE M M AE N
عمود|RH AE M UW D
عمودي|RH AE M UW D IY Y Y
عموما|RH UW M UW M AE N
عمى|RH AE M M AE
عميد|RH AE M IY D
عميق|RH AE M IY K
عميم|RH AE M IY M
عن|RH AE N
عناب|RH UW N N AE B
عنابة|RH UW N N AE B AE
عناد|RH N AE D
عناية|RH IY N AE Y AE
عنب|RH UW N AE B
عنبا|RH AE M B AE
عنبر|RH AE N B AE RRR
عنبروت|RH AE N B AE RRR UW T
عند|RH IY N D AE
عندليب|RH AE N D AE L IY B
عندما|RH IY N D AE M AE
عنزروت|RH AE N Z AE RRR UW T
عنصر|RH UW N S UW RRR
عنصري|RH UW N S UW RRR IY Y Y
عنصرية|RH UW N S UW RRR IY Y Y AE
عنصل|RH UW N S UW L
عنق|RH UW N UW K
عنقاد|RH IY N K AE D
عنقود|RH UW N K UW D
عنكبوت|RH AE N K B UW T
عنوان|RH UW N W AE N
عنوسة|RH UW N UW S AE
عنى|RH AE N AE
عنيف|RH AE N IY F
عوائد|RH AE W AE Q IY D
عوار|RH UW W W AE RRR
عواري|RH AE W AE RRR IY Y Y
عوارية|RH AE W AE RRR IY Y Y AE
عوج|RH IY W AE D
عود|RH UW D
عودة|RH AE W D AE
عوسج|RH AE W S AE D
عوينات|RH UW W AE Y N AE T
عيادة|RH IY Y AE D AE
عيان|RH IY Y AE N
عيد|RH IY D AE
عيدية|RH IY D IY Y Y AE
عيسى|RH IY S AE
عيش|RH AE Y SH
عيشوم|RH AE Y SH UW M
عيشومة|RH AE Y SH UW M AE
عيلة|RH AE Y L AE
عين|RH AE Y N
عيني|RH AE Y N IY Y Y
غ|RH AE Y N
غائر|HH AE Q IY RRR
غاب|HH AE B AE
غابة|HH AE B AE
غابوي|HH AE B AE W IY Y Y
غابي|HH AE B IY Y Y
غادر|HH AE D AE RRR AE
غار|HH AE RRR AE
غارة|HH AE RRR AE
غاز|HH AE Z
غاسول|HH AE S UW L
غاشم|HH AE SH IY M
غاص|HH AE S AE
غاضب|HH AE D IY B
غاظ|HH AE DH AE
غافت|HH AE F IY T
غافث|HH AE F IY TH
غالب|HH AE L IY B
غالبية|HH AE L IY B IY Y Y AE
غامض|HH AE M IY D
غامق|HH AE M IY G
غانا|HH AE N AE
غاية|HH AE Y AE
غباء|HH AE B AE Q
غبار|HH UW B AE RRR
غباوة|HH AE B AE W AE
غبط|HH AE B AE T AE
غبن|HH UW B N
غبي|HH AE B IY Y AE
غبيراء|HH UW B AE Y RRR AE Q
غد|HH AE D
غدا|HH AE D AE N
غدة|HH UW D D AE
غدير|HH AE D IY RRR
غذى|HH AE DH DH AE
غراب|HH UW RRR AE B
غرابيل|HH AE RRR AE B IY L
غرامة|HH AE RRR AE M AE
غرامي|HH AE RRR AE M IY Y Y
غرب|HH UW RRR B
غربال|HH IY RRR B AE L
غربالي|HH IY RRR B AE L IY Y Y
غربة|RH UH RRR B AA
غرة|HH UW RRR RRR AE
غرد|HH UW RRR D
غردق|HH AE RRR D AE K
غرر|HH UW RRR AE RRR
غرس|HH AE RRR AE S AE
غرفة|HH UW RRR F AE
غرق|RH IH RRR AH0 G
غرقل|HH IY RRR K IY L
غرلة|HH UW RRR L AE
غرمول|HH UW RRR M UW L
غرنوق|HH UW RRR N UW K
غرور|HH UW RRR UW RRR
غريب|HH AE RRR IY B
غريبة|HH UW RRR RRR AE Y B AE
غريغوريوس|HH IY RRR IY HH UW RRR IY Y UW S
غرين|HH AE RRR IY N
غزال|HH AE Z AE L
غزاوة|HH AE Z AE W AE
غزة|HH AE Z Z AE
غزلي|HH AE Z AE L IY Y Y
غزير|HH AE Z IY RRR
غسالة|HH AE S S AE L AE
غسق|HH AE S AE K
غسل|HH AE S AE L AE
غسول|HH AE S UW L
غشى|HH AE SH SH AE
غشيم|HH AE SH IY M
غص|HH AE S S AE
غصب|HH AE S AE B AE
غصة|HH UW S S AE
غضاضة|HH AE D AE D AE
غضب|HH UW D IY B AE
غضبان|HH AE D B AE N
غضة|HH AE D D AE
غطس|HH AE T AE S AE
غطى|HH AE T T AE
غفر|HH AE F AE RRR AE
غفل|HH AE F AE L AE
غفلة|HH AE F L AE
غلا|HH AE L AE
غلاء|HH AE L AE Q
غلاف|HH IY L AE F
غلاية|HH AE L L AE Y AE
غلب|HH AE L L AE B AE
غلثى|HH AE L TH AE
غلط|HH AE L IY T AE
غلفة|HH UW L F AE
غلقة|HH IY L K AE
غليون|HH AE L Y UW N
غمام|HH AE M AE M AE
غمامة|HH IY M AE M AE
غمد|HH IY M D
غمغم|HH AE M HH AE M AE
غمود|HH UW M UW D
غمى|HH AE M M AE
غن|HH AE N N AE
غناء|HH IY N AE Q
غنة|HH UW N N AE
غني|HH UW N N IY Y AE
غنيمة|HH AE N IY M AE
غواتيمالا|HH W AE T IY M AE L AE
غواصة|HH AE W W AE S AE
غوشنة|HH AE W SH AE N AE
غويانا|HH UW Y AE N AE
غيبة|HH IY B AE
غيبوبة|HH AE Y B UW B AE
غيرة|HH AE Y RRR AE
غيظ|HH AE Y DH
غيلم|HH AE Y L AE M
غين|HH AE Y N
غيور|HH AE Y UW RRR
ف|F AE Q
فأر|F AE Q RRR
فأس|F AE Q S
فأل|F AE L
فؤاد|F UW Q AE D
فؤول|F UW Q UW L
فئة|F IY Q AE
فئران|F IY Q RRR AE N
فاء|F AE Q
فات|F AE T AE
فاتحة|F AE T IY HH AE
فاتر|F AE T IY RRR
فاتن|F AE T IY N
فاتية|F AE T IY Y AE
فاثور|F AE TH UW RRR
فاجأ|F AE D AE Q AE
فاجرة|F AE D IY RRR AE
فاجعة|F AE D IY RH AE
فاح|F AE HH AE
فاحش|F AE HH AE SH AE
فادي|F AE D IY
فارع|F AE RRR IY RH
فارغ|F AE RRR IY HH
فاسد|F AE S IY D
فاشرا|F AE SH IY RRR AE
فاصوليا|F AE S UW L IY Y AE
فاصولياء|F AE S UW L IY Y AE Q
فاض|F AE D IY N
فاطمة|F AE T IY M AE
فاعل|F AE RH IY L
فاغرة|F AE HH IY RRR AE
فاقة|F AE K AE
فاكرة|F AE K IY RRR AE
فاكهة|F AE K IY HH AE
فالجي|F AE L AE D IY Y Y
فالود|F AE L UW D
فالودة|F AE L UW D AE
فالودج|F AE L UW D AE D
فالودق|F AE L UW D AE K
فالوذ|F AE L UW DH
فالوذة|F AE L UW DH AE
فالوذج|F AE L UW DH AE D
فالوذق|F AE L UW DH AE K
فانوس|F AE N UW S
فانيد|F AE N IY D
فانيذ|F AE N IY DH
فاوض|F AE W AE D AE
فبراير|F IY B RRR AE Y IY RRR
فتاة|F AE T AE HH
فتاحة|F AE T T AE HH AE
فتة|F AE T T AE T
فتح|F AE T HH
فتحة|F AE T HH AE
فتخاء|F AE T HH AE Q
فتش|F AE T T AE SH AE
فتق|F AE T K
فتوش|F AE T T UW SH
فتوى|F AE T W AE
فتى|F AE T AE N
فجأة|F AE D Q AE T AE N
فجائي|F UW D AE Q IY Y Y
فجل|F UW D L
فجور|F UW D UW RRR
فحشاء|F AE HH SH AE Q
فحص|F AE HH AE S AE
فحم|F AE HH M
فخار|F AE HH HH AE RRR
فخور|F AE HH UW RRR
فداء|F IY D AE Q
فدائي|F IY D AE Q IY Y Y
فدائيون|F IY D AE Q IY Y Y UW N
فداحة|F AE D AE HH AE
فدان|F AE D D AE N
فداوش|F IY D AE W IY SH
فدن|F AE D AE N
فدوى|F AE D W AE
فدى|F AE D AE
فرأ|F AE RRR AE Q
فراء|F AE RRR AE Q
فراسيون|F AE RRR AE S IY Y UW N
فراشة|F AE RRR AE SH AE
فراطة|F UW RRR AE T AE
فراغ|F UW RRR RRR AE HH
فرامبواز|F RRR AE M B W AE Z
فران|F AE RRR RRR AE N
فراولة|F AE RRR AE W L AE
فربيون|F AE RRR B IY Y UW N
فرث|F AE RRR TH
فرجون|F IY RRR D AE W N
فرحة|F AE RRR HH AE
فرخ|F AE RRR HH
فردي|F AE RRR D IY Y Y
فرسخ|F AE RRR S AE HH
فرشاة|F UW RRR SH AE HH
فرصاد|F IY RRR S AE D
فرصة|F UW RRR S AE
فرضية|F AE RRR D IY Y Y AE
فرع|F AE RRR RH
فرعون|F IY RRR RH OW0 N
فرغ|F AE RRR RRR AE HH AE
فرغة|F AE RRR IY HH AE
فرفحين|F AE RRR F AE HH IY N
فرفيري|F IY RRR F IY RRR IY Y Y
فرق|F IY RRR AE K
فرقاطة|F IY RRR K AE T AE
فرك|F AE RRR AE K AE
فركس|F IY RRR K IY S
فرمل|F AE RRR M AE L AE
فرن|F UW RRR N
فرنب|F IY RRR N IY B
فرند|F IY RRR IY N D
فرنسا|F AE RRR AE N S AE
فرهد|F UW RRR HH UW D
فرهود|F UW RRR HH UW D
فرو|F AE RRR W
فروغ|F UW RRR UW HH
فريسة|F AE RRR IY S AE
فريق|F IY RRR IY D
فز|F AE Z Z AE
فسا|F AE S AE
فسافس|F AE S AE F IY S
فستان|F UW S T AE N
فستق|F UW S T UW K
فسح|F AE S HH
فسر|F AE S S AE RRR AE
فسقية|F IY S K IY Y Y AE
فسيفساء|F UW S AE Y F IY S AE Q
فشقار|F AE SH K AE RRR
فشقر|F AE SH K AE RRR
فص|F UW S S
فصاحة|F AE S AE HH AE
فصح|F UW S UW HH
فصد|F AE S AE D AE
فصولياء|F AE S UW L IY Y AE Q
فصيل|F AE S IY L
فصيلة|F AE S IY L AE
فضاء|F AE D AE Q
فضائي|F AE D AE Q IY Y Y
فضة|F IY D D AE
فضح|F AE D AE HH AE
فضول|F UW D UW L
فضولي|F UW D UW L IY Y Y
فضي|F IY D D IY Y Y
فضيحة|F AE D IY HH AE
فطيس|F IY T T IY S
فطيسة|F IY T T IY S AE
فظ|F AE DH DH
فظع|F AE DH UW RH AE
فعالية|F AE RH RH AE L IY Y Y AE
فعل|F IY RH L
فعلا|F IY RH L AE N
فقاعة|F UW K K AE RH AE
فقاقيع|F AE K AE K IY RH
فقد|F AE K D
فقري|F IY K RRR IY Y Y
فقس|F AE K AE S AE
فقوس|F AE K K UW S
فقوسة|F AE K K UW S AE
فقير|F AE K IY RRR
فقيه|F AE K IY HH
فك|F AE K K AE
فكاهي|F UW K AE HH IY Y Y
فكة|F AE K K AE
فكر|F IY K RRR
فكرة|F IY K RRR AE
فلاح|F AE L L AE HH
فلاديمير|V L AE D IY M IY RRR
فلاش|F L AE SH
فلان|F UW L AE N
فلانة|F UW L AE N AE
فلت|F AE L L AE T AE
فلح|F AE L AE HH AE
فلز|F IY L IY Z Z
فلس|F UW L S
فلسطين|F IY L AE S T IY N
فلسفة|F AE L S AE F AE
فلسقية|F IY L AE S K IY Y Y AE
فلفل|F UW L F UW L
فلك|F UW L K
فلكي|F AE L AE K IY Y Y
فلم|F IY L M
فلنجة|F IY L IY N D AE
فلو|F UW L UW W W
فليفلة|F UW L AE Y F IY L AE
فم|F AE M
فن|F AE N N
فناء|F IY N AE Q
فنار|F AE N AE RRR
فنان|F AE N N AE N
فنجان|F IY N D AE N
فنجنكشت|F AE N D AE N K UW SH T
فندق|F UW N D UW K
فنزويلا|F EH0 N Z UW W EH0 L AE
فنطاس|F IY N T AE S
فنلندا|F IY N L AE N D AE
فني|F AE N IY Y AE
فهرس|F AH0 HH RRR AH0 S
فهم|F AE HH M
فوار|F AE W W AE RRR
فوارة|F AE W W AE RRR AE
فواق|F UW W AE K
فوتنج|F UW T AE N AE D
فوج|Q AE F W AE D
فودنج|F UW D AE N AE D
فوذنج|F UW DH AE N AE D
فور|F AE W RRR AE
فورا|F AE W RRR AE N
فوري|F AE W RRR IY Y Y
فوز|F AE W Z
فوشي|F UW SH IY Y Y
فوض|F AE W W AE D AE
فوضوي|F AE W D AE W IY Y Y
فوضوية|F AE W D AE W IY Y Y AE
فوضى|F AE W D AE
فوطة|F UW T AE
فوف|F UW F
فوفل|F UW F AE L
فولاذ|F UW L AE DH
فولت|F UW L T
فوم|F UW M
في|F IY
فيء|F AE Y Q
فيتامين|F IY T AE M IY N
فيتق|F AE Y T AE K
فيتنام|V Y IY T N AE M
فيثاغورس|F IY TH AE HH UW RRR AE S
فيج|F AE Y D
فيجل|F AE Y D AE L
فيجن|F AE Y D AE N
فيديو|V IY D Y OW0
فيروز|F AE Y RRR UW Z
فيروزي|F AE Y RRR UW Z IY Y Y
فيروس|V IY RRR UW S
فيل|F IY L
فيلم|F IY L M
فيما|F IY M AE
فينا|V IY Y EH0 N N AE
فينة|F AE Y N AE
ق|Q
قاء|K AE Q AE
قائد|K AE Q IY D
قائظ|K AE Q IY DH
قائف|K AE Q IY F
قائمة|K AE Q IY M AE
قابل|K AE B AE L AE
قابلة|Q EH0 B L AE
قابلية|K AE B IY L IY Y Y AE
قابيل|K AE B IY L
قاتل|G AE T IY L
قاتم|K AE T IY M
قاجوج|K AE D UW D
قاد|K AE D AE
قادر|K AE D IY RRR
قادس|K AE D IY S
قادوس|K AE D UW S
قارب|Q AE RRR EH0 B
قارة|K AE RRR RRR AE
قارن|K AE RRR AE N AE
قارورة|K AE RRR UW RRR AE
قارون|K AE RRR UW N
قازاقستان|K AE Z AE K IY S T AE N
قاس|K AE S IY N
قاسم|G AE S IY M
قاض|K AE D AE
قاطعة|K AE T IY RH AE
قاع|Q AE RH
قاعة|Q AE RH AE
قاعدة|K AE RH IY D AE
قاف|K AE F AE
قافلة|K AE F IY L AE
قافية|K AE F IY Y AE
قاقلة|K AE K UW L L AE
قال|Q AE L
قالب|K AE L IY B
قاليقالا|K AE L IY K AE L AE
قاليقلا|K AE L IY K AE L AE
قام|G AE M
قاموس|K AE M UW S
قانون|K AE N UW N
قاوق|K AE W UW K
قاووش|K AE W UW SH
قاوون|K AE W UW N
قاوونة|K AE W UW N AE
قايين|K AE Y IY N
قبائلي|K AE B AE Q IY L IY Y Y
قبائلية|K AE B AE Q IY L IY Y Y AE
قبالة|K UW B AE L AE T AE
قبان|K AE B B AE N
قبة|K UW B B AE
قبج|K AE B D
قبر|G UW B B AE RRR
قبرة|K UW B B AE RRR AE
قبض|K AE B D
قبط|K UW B T
قبطان|K UW B T AE N
قبع|K AE B AE RH AE
قبعة|K UW B B AE RH AE
قبلا|K AE B L AE N
قبو|K AE B W
قبول|K UW B UW L
قبيح|K AE B IY HH
قبيلة|G AE B IY L AE
قتاد|K AE T AE D
قتبان|K AE T AE B AE N
قتل|K IY T L
قتلة|K IY T L AE HH
قثاء|K UW TH TH AE Q
قحبة|K AE HH B AE
قد|K UW D D
قداحة|K AE D D AE HH AE
قداد|K UW D AE D
قدرة|K UW D RRR AE
قدم|K UW D UW M
قدوم|K AE Y D UW M
قديم|G AE D IY M
قذارة|K AE DH AE RRR AE
قذال|K AE DH AE L
قذالي|K AE DH AE L IY Y Y
قذة|K UW DH DH AE
قذيفة|K AE DH IY F AE
قرآني|K UW RRR Q AE N IY Y Y
قرأ|K AE RRR AE Q AE
قراءة|K IY RRR AE Q AE
قرابة|K UW RRR AE B AE T AE
قراد|K UW RRR AE D
قرار|K AE RRR AE RRR
قراسيا|K AE RRR AE S IY Y AE
قراص|K UW RRR RRR AE S
قرانيا|K AE RRR AE N IY Y AE
قرب|K UW RRR B AE
قربان|K UW RRR B AE N
قرحة|K UW RRR HH AE
قرد|G IY RRR D
قرر|G AE RRR RRR AE RRR
قرسطون|K AE RRR AE S T UW N
قرش|K IY RRR SH
قرص|K UW RRR S
قرصان|K UW RRR S AE N
قرصة|K AE RRR S AE
قرصعنة|K UW RRR S AE RH AE N N AE
قرصن|K AE RRR S AE N AE
قرصنة|K AE RRR S AE N AE
قرضئ|K IY RRR D IY Q
قرطاجة|K AE RRR T AE D AE
قرطاجي|K AE RRR T AE D IY Y Y
قرطاس|K UW RRR T AE S
قرطم|K UW RRR T UW M
قرظ|K AE RRR AE DH
قرف|K AE RRR AE F
قرفص|K AE RRR F AE S AE
قرفصاء|K UW RRR F UW S AE Q
قرقس|K IY RRR K IY S
قرقع|K AE RRR K AE RH AE
قرمزي|K IY RRR M IY Z IY Y Y
قرمل|K AE RRR M AE L
قرميد|K IY RRR M IY D
قرميدة|K IY RRR M IY D AE
قرن|K AE RRR N
قرنبيط|K AE RRR N AE B IY T
قرنفل|K AE RRR AE N F UW L
قرنوة|K AE RRR N UW W AE
قروش|K UW RRR UW SH
قريب|K AE RRR IY B
قريبا|K AE RRR IY B AE N
قرية|K AE RRR Y AE
قريدس|K UW RRR AE Y D IY S
قريدسة|K UW RRR AE Y D IY S AE
قريش|K UW RRR AE Y SH
قز|K AE Z Z
قستوس|K IY S T UW S
قسر|K AE S AE RRR AE
قسطاس|K UW S T AE S
قسطران|K AE S T AE RRR AE N
قسم|K IY S M
قسنطينة|K UW S AE N T IY N AE
قسوة|K AE S W AE
قسيس|K IY S S IY S
قشد|K AE SH AE D AE
قشدة|K IY SH D AE
قشدي|K IY SH D IY Y Y
قشر|G IY SH IY RRR
قشطة|K IY SH T AE
قشع|K AE SH AE RH AE
قشعريرة|K UW SH AE RH RRR IY RRR AE
قشف|K AE SH SH AE F AE
قشلة|K AE SH L AE
قشمير|K IY SH M IY RRR
قصاب|K AE S S AE B
قصاج|K UW S AE D
قصار|G UW S AE RRR
قصبة|K AE S B AE
قصدير|K AE S D IY RRR
قصرية|K AE S RRR IY Y Y AE
قصعين|K AE S RH IY N
قصي|K UW S S IY
قصيبة|K UW S AE Y B AE
قصير|K AE S IY RRR
قصيل|K AE S IY L
قضائي|K AE D AE Q IY
قضم|K AE D M
قضيب|K AE D IY B
قضيبي|K AE D IY B IY Y Y
قطار|K IY T AE RRR
قطارة|K AE T T AE RRR AE
قطبي|K UW T B IY Y Y
قطة|K IY T T AE
قطران|K IY T RRR AE N
قطرب|K UW T RRR UW B
قطع|K UW T AE RH
قطعة|K UW T RH AE
قطعي|K AE T RH IY Y Y
قطف|K AE T AE F AE
قطلب|K AE T L AE B
قطمة|G AE T M AE
قطيرة|K UW T AE Y RRR AE
قطيع|K AE T IY RH
قطيفة|K AE T IY F AE
قعاب|K IY RH AE B
قعب|K AE RH RH AE B AE
قعد|G AE RH AE D
قفاز|K UW F F AE Z
قفازات|K UW F F AE Z AE T
قفة|K UW F F AE
قفص|G AE F AE S
قفقف|K AE F K AE F AE
قفلوط|K AE F AE L UW T
قفير|K AE F IY RRR
ققنس|K UW K N UW S
ققنوس|K UW K N UW S
قلائد|K AE L AE Q IY D
قلادة|K IY L AE D AE
قلام|K UW L L AE M
قلاووز|K AE L AE W UW Z
قلاووظ|K AE L AE W UW DH
قلاية|K IY L L AE Y AE
قلب|K UW L L AE B
قلعة|K IY L RH AE
قلعي|K AE L RH IY Y Y
قلقاس|K UW L K AE S
قلقاسة|K UW L K AE S AE
قلقديس|K AE L K AE D IY S
قلقطار|K AE L K AE T AE RRR
قلل|K AE L L AE L AE
قلم|Q AE L AE M
قلما|K AE L L AE M AE
قلنسوة|K AE L AE N S UW W AE
قلوي|K IY L W IY Y Y
قليب|K AE L IY B
قلية|K IY L L IY Y Y AE
قليل|K AE L IY L
قليلا|K AE L IY L AE N
قماش|G UW M AE SH
قماط|G M AE T
قمة|K IY M M AE
قمح|K AE M HH
قمرة|K AE M RRR AE
قمل|K AE M L
قملة|K AE M L AE
قميحة|K AE M IY HH AE
قناة|K AE N AE HH
قناع|K IY N AE RH
قناعة|K AE N AE RH AE
قنبريس|K AE N B AE RRR IY S
قنبلة|K UW N B UW L AE
قنبيط|K UW N N AE B IY T
قنبيل|K AE N B IY L
قنجة|K AE N D AE
قندهار|K UW N D UW HH AE RRR
قنديد|K IY N D IY D
قنديل|K IY N D IY L
قنص|K AE N S
قنصل|K UW N S UW L
قنصلية|K UW N S UW L IY Y Y AE
قنطار|K IY N T AE RRR
قنطر|K AE N T AE RRR AE
قنطرة|K AE N T AE RRR AE
قنطور|K AE N T UW RRR
قنينة|K IY N N IY N AE
قهقه|K AE HH K AE HH AE
قهوة|Q AE HH W EH
قواطع|K AE W AE T IY RH
قوة|K UW W W AE
قوت|K UW T
قورح|K UW RRR AE HH
قوس|K AE W W AE S AE
قوش|K UW SH
قوصرة|K AE W S AE RRR AE
قوض|K AE W W AE D AE
قوق|K UW K
قوقع|K AE W K AE RH
قوقعة|K AE W K AE RH AE
قول|K AE W L
قولنج|K UW L AE N D
قوم|K AE W M
قومية|K AE W M IY Y Y AE
قونية|K UW N IY Y AE
قوي|K AE W IY Y Y
قويعدة|K UW W AE Y RH IY D AE
قيافة|K IY Y AE F AE
قيان|K IY Y AE N
قيتار|K IY T AE RRR
قيتارة|K IY T AE RRR AE
قيثار|K IY TH AE RRR
قيثارات|K IY TH AE RRR AE T
قيثارة|K IY TH AE RRR AE
قيراط|K IY RRR AE T
قيرغيزستان|K IY RRR HH IY Z IY S T AE N
قيشور|K AE Y SH UW RRR
قيصر|K AE Y S AE RRR
قيصوم|K AE Y S UW M
قيطون|Q AE T UW N
قيظ|K AE Y DH
قيقب|K AE Y K AE B
قيلولة|K AE Y L UW L AE
قيمة|G IY M AE
قينة|K AE Y N AE
ك|K AA F
كآبة|K AE Q AE B AE
كأب|K AE Q B
كأس|K AE Q S
كأن|K AE Q AE N N AE
كائن|K AE Q IY N
كابل|K AE B UW L
كابلي|K AE B UW L IY Y Y
كابوس|K AE B UW S
كابول|K AE B UW L
كاتدرائية|K AE T IY D RRR AE Q IY Y Y AE
كاتيون|K AE T Y UW N
كاحل|K AE HH IY L
كادس|K AE D IY S
كاذب|K AE DH IY B
كاذي|K AE DH IY Y Y
كاراتيه|K AE RRR AE T EH0
كاراطي|K AE RRR AE T IY
كارة|K AE RRR AE
كارى|K AE RRR AE
كازاخستان|K AE Z AE HH IY S T AE N
كازخستان|K AE Z AE HH IY S T AE N
كازون|K AE Z UW N
كاسيت|K AE S IY T
كاشف|K AE SH IY F
كاشم|K AE SH IY M
كاعب|K AE RH IY B
كاغد|K AE HH IY DH
كاغذ|K AE HH IY DH
كاغيد|K AE HH IY D
كاف|K AE F IY N
كافأ|K AE F AE Q AE
كافتيريا|K AE F IY T IY RRR IY Y AE
كافر|K AE F IY RRR
كافور|K AE F UW RRR
كاكنج|K AE K IY N D
كالون|K AE L UW N
كامبودي|K AE M B UW D IY Y Y
كامبوديا|K AE M B OW0 D IY Y AE
كامخ|K AE M IY HH
كامرا|K AE M RRR AE
كامل|K AE M IY L
كان|K AE N AE
كانبرا|K AE N B IY RRR AE
كانون|K AE N UW N
كاهنة|K AE HH IY N AE
كبابة|K UW B AE B AE
كباث|K AE B AE TH
كبد|K AE B IY D
كبر|K AE B UW RRR AE
كبرياء|K IY B RRR IY Y AE Q
كبريت|K IY B RRR IY T
كبش|K AE B SH
كبكب|K AE B K AE B AE
كبل|K IY B L
كبير|K B IY RRR
كبيرة|K AE B IY RRR AE
كبيس|K AE B IY S
كبيكج|K AE B IY K AE D
كتاب|K UW T T AE B
كتابة|K IY T AE B AE
كتابخانة|K IY T AE B HH AE N AE
كتان|K AE T T AE N
كتب|K UW T UW B
كتف|K IY T F
كتلة|K UW T L AE
كثافة|K AE TH AE F AE
كثيب|K AE TH IY B
كثير|K AE TH IY RRR
كثيرا|K AE TH IY RRR AE
كثيراء|K AE TH IY RRR AE Q
كثيف|K AE TH IY F
كحلاء|K AE HH L AE Q
كدس|K AE D S
كدين|K UW D IY N
كذاب|K AE DH DH AE B
كذين|K UW DH IY N
كذينق|K UW DH IY N AE K
كراث|K UW RRR RRR AE TH
كراج|G AE RRR AE D
كراخة|K AE RRR AE HH AE
كراز|K UW RRR RRR AE Z
كراميل|K AE RRR AE M IY L
كراني|K AE RRR RRR AE N IY Y Y
كراويا|K AE RRR AE W IY Y AE
كراوية|K AE RRR AE W IY Y AE
كرباج|K UW RRR B AE D
كربة|K UW RRR B AE
كربون|K AE RRR B UW N
كرة|K UW RRR AE
كرج|K UW RRR D
كرح|K IY RRR HH
كرخ|K IY RRR HH
كردون|K UW RRR D UW N
كرز|K AE RRR AE Z
كرس|K IY RRR S
كرسوع|K UW RRR S UW RH
كرسي|K UW RRR S IY Y Y
كرفس|K AE RRR AE F S
كرك|K UW RRR K
كركم|K UW RRR K UW M
كركند|K AE RRR K AE N D
كرنب|K UW RRR UW N B
كرنيب|K IY RRR N IY B
كره|K UW RRR HH
كرها|K AE RRR HH AE N
كرواتي|K UW RRR UW W AE T IY Y Y
كرواتيا|K UW RRR UW W AE T IY Y AE
كروياء|K AE RRR AE W Y AE Q
كروية|K UW RRR AE W IY Y Y AE
كرى|K AE RRR AE
كرياس|K IY RRR Y AE S
كزاز|K UW Z Z AE Z
كزبرة|K AH0 Z B AH0 RRR AH0
كزمازج|K AE Z M AE Z AE D
كزمازق|K AE Z M AE Z AE K
كزمازك|K AE Z M AE Z AE K
كسا|K AE S AE
كساء|K IY S AE Q
كسبة|K UW S B AE
كستبان|K UW S T UW B AE N
كستج|K UW S T AE D
كستيج|K UW S T IY D
كسحاء|K AE S HH AE Q
كسرة|K AE S RRR AE
كسوة|K UW S W AE
كسوف|K UW S UW F
كسيح|K AE S IY HH
كشتبان|K UW SH T UW B AE N
كشمش|K IY SH M IY SH
كشنى|K UW SH N AE
كشوت|K UW SH UW TH
كشوث|K UW SH UW TH
كعبة|K AE RH B AE
كعك|K AE RH K
كفات|K IY F AE T
كفاح|K IY F AE HH
كفالة|K AE F AE L AE
كفرية|K UW F RRR IY Y Y AE
كفى|K AE F AE
كل|K UW L L
كلأ|K AE L AE Q AE
كلب|K AE L B
كلبة|K AE L B AE
كلح|K AE L AE HH AE
كلخ|K AE L HH
كلك|K AE L AE K
كلكلانج|K AE L K AE L AE N AE D
كلما|K UW L L AE M AE
كلمة|K AE L IY M AE
كلميم|G UW L M IY M
كلوتة|K AE L L UW T AE
كليب|K L IY B
كليل|K AE L IY L
كم|K UW M
كمء|K AE M Q
كمأ|K AE M AE Q
كمأة|K AE M Q AE
كماة|K UW M AE HH
كماشير|K AE M AE SH IY RRR
كمام|K IY M AE M
كمامة|K IY M AE M AE
كمان|K AE M AE N
كمبيوتر|K AE M B Y UW T AE RRR
كمثراة|K UW M M AE TH RRR AE HH
كمثرى|K UW M M AE TH RRR AE
كمح|K AE M AE HH AE
كمر|K AE M AE RRR
كمون|K AE M M UW N
كمي|K AE M IY Y Y
كميت|K UW M AE Y T
كناب|K IY N AE B
كنار|K AE N AE RRR
كنارة|K IY N N AE RRR AE
كناية|K IY N AE Y AE
كنباث|K IY N B AE TH
كندا|K AE N AE D AE
كندس|K UW N D UW S
كندوج|K AE N D UW D
كنز|K AE N Z
كنزة|K AE N Z AE
كنف|K AE N AE F AE
كنية|K UW N Y AE
كنيسة|K AE N IY S AE
كهرباء|K AE HH RRR UW B AE Q
كهرمان|K AE HH RRR AE M AE N
كهرو|K AE HH RRR UW
كهروتقني|K AE HH RRR UW T IY K N IY Y Y
كهروحراري|K AE HH RRR UW HH AE RRR AE RRR IY Y Y
كهروساكن|K AE HH RRR UW S AE K IY N
كهروستاتيكي|K AE HH RRR UW S T AE T IY K IY Y Y
كهروسكوني|K AE HH RRR UW S UW K UW N IY Y Y
كهروضوئي|K AE HH RRR UW D AE W Q IY Y Y
كهرومائي|K AE HH RRR UW M AE Q IY Y Y
كهرومتحرك|K AE HH RRR UW M UW T AE HH AE RRR RRR IY K
كهرومغناطيسي|K AE HH RRR UW M IY HH N AE T IY S IY Y Y
كهرومنزلي|K AE HH RRR UW M AE N Z IY L IY Y Y
كهف|K AH0 HH F
كهنوت|K AE HH AE N UW T
كواكب|K AE W AE K IY B
كوالا|K UW W AE L AE
كوب|K UW B
كوبا|K UW B AE
كوبنهاجن|K UW B IY N HH AE G IY N
كوبنهاغن|K UW B IY N HH AE HH AE N
كوة|K UW W W AE
كوثر|K AE W TH AE RRR
كوثل|K AE W TH AE L
كوج|K UW D
كوخ|K UW HH
كودن|K AE W D AE N
كودين|K UW D IY N
كوذين|K UW DH IY N
كورة|K UW RRR AE
كوريا|K UW RRR IY Y AE
كوز|K UW Z
كوسا|K UW S AE
كوستاريكا|K OW0 S T AE RRR IY K AE
كوسوفو|K UW S UW F UW
كوسى|K UW S AE
كوشاد|K UW SH AE D
كوع|K UW RH
كوكب|K AE W K AE B
كوكبة|K AE W K AE B AE
كولان|K UW L AE N
كولومبو|K UW L UW M B UW
كولومبيا|K OW0 L OW0 M B IY Y AE
كوم|K OW0 M
كون|K AE W W AE N AE
كويكب|K UW W AE Y K IY B
كيد|K AE Y D
كيرلس|K IY RRR UW L UW S
كيف|K AE Y Y AE F AE
كيلوغرام|K IY L UW HH RRR AE M
كيلومتر|K IY L OW0 M IY T EH0 RRR
كينيا|K IY N Y AE
كيول|K AE Y Y UW L
ل|L
لأك|L AE Q AE K AE
لألأ|L AE Q L AE Q AE
لأن|L IY Q AE N N AE
لؤلؤ|L UW Q L UW Q
لؤلؤة|L UW Q L UW Q AE
لئلا|L IY Q AE L L AE
لا|L AE
لاءم|L AE Q AE M AE
لاأدري|L AE Q AE D RRR IY Y Y
لائحة|L AE Q IY HH AE
لاتفي|L AE T V IY Y Y
لاتفيا|L AE T V IY Y AE
لاث|L AE TH AE
لاج|L AE D AE
لاح|L AE HH AE
لاحق|L AE HH IY K
لاحم|L AE HH IY M
لادن|L AE D AE N
لاذ|L AE DH AE
لاذن|L AE DH AE N
لازوردي|L AE Z UW W AE RRR D IY Y Y
لاسلطوي|L AE S UW L T AE W IY Y Y
لاسلطوية|L AE S UW L T AE W IY Y Y AE
لاسلكي|L AE S IY L K IY Y Y
لاط|L AE T AE
لاعية|L AE RH IY Y AE
لافتة|L AE F IY T AE
لام|L AE M AE
لامبالاة|L AE M UW B AE L AE HH
لاهوتي|L AE HH UW T IY Y Y
لاهور|L AE HH UW RRR
لاوس|L AE W S
لبأ|L IY B AE Q
لباس|L IY B AE S
لبان|L UW B AE N
لبسة|L IY B S AE
لبلاب|L AE B L AE B
لبلابي|L AE B L AE B IY Y Y
لبلبي|L AE B L AE B IY Y Y
لبن|L AE B AE N
لبنان|L UW B N AE N
لبوس|L AE B UW S
لبى|L AE B B AE
لتواني|L IY T W AE N IY Y Y
لتوانيا|L IY T UW W AE N IY Y AE
لثة|L IY TH AE
لثغة|L UW TH HH AE
لثم|L AE TH AE M AE
لج|L UW D D
لجأ|L AE D AE Q AE
لجأة|L AE D AE Q AE
لجئ|L AE D AE Q AE
لجام|L IY D AE M
لجنة|L AE D N AE
لجوء|L UW D UW Q
لجين|L UW D AE Y N
لحاء|L IY HH AE Q
لحاق|L AE HH AE K
لحج|L AE HH HH AE D AE
لحظ|L AE HH DH
لحظتذاك|L AE HH DH AE T AE DH AE K AE
لحق|L AE HH K
لحلاح|L AE HH L AE HH
لحم|L AE HH M
لحوج|L AE HH W AE D AE
لدغ|L AE D AE HH AE
لذلك|L IY DH AE L IY K AE
لذيذ|L AE DH IY DH
لزاق|L IY Z AE K
لزج|L AE Z IY D AE
لسان|L IY S AE N
لسع|L AE S AE RH AE
لصاق|L IY S AE K
لصف|L AE S AE F
لصق|L AE S S AE K AE
لطم|L AE T AE M AE
لطيف|L AE T IY F
لعبة|L UW RH B AE
لعل|L AE RH L
لعنة|L AE RH N AE
لغة|L UW HH AE
لغط|L AE HH AE T AE
لغويات|L UW HH AE W IY Y Y AE T
لفافة|L IY F AE F AE
لفف|L AE F F AE F AE
لفيفة|L AE F IY F AE
لقاح|L IY K AE HH
لقب|L AE K K AE B
لقح|L AE K AE HH AE
لقد|L AE K AE D
لقمة|L UW K M AE
لقوة|L AE K W AE
لك|L AE K K
لكز|L AE K Z
لكم|L AE K AE M AE
لكمة|L AE K M AE
لكن|L AE K IY N N AE
لكنة|L UW K N AE
للأسف|L IY L Q AE S AE F
للغاية|L IY L HH AE Y AE T IY
لله|L IY L L AE HH IY
لم|L UW M
لماذا|L IY M AE DH AE
لمح|L AE M HH
لمع|L AE M M AE RH AE
لمى|L AE M AE
لن|L AE N
لندن|L UW N D UW N
لندني|L UW N D UW N IY Y Y
لها|L AE HH AE
لهاث|L UW HH AE TH
لهب|L AE HH IY B AE
لهث|L AE HH IY TH AE
لهجة|L AH0 HH D AH0
لهذا|L IY HH AE DH AE
لهفة|L AE HH F AE
لهى|L AE HH HH AE
لهي|L AE HH IY Y AE
لهيب|L AE HH IY B
لو|L AE W
لواء|L IY W AE Q
لواط|L IY W AE T
لوح|L OW0 HH
لوحة|L AE W HH AE
لورد|L OW0 RRR D
لوز|L AE W Z
لوط|L UW T
لوطي|L UW T IY Y Y
لولا|L AE W L AE
لومي|L UW M IY
لون|L AE W W AE N AE
لوى|L AE W AE
لوياثان|L AE W IY Y AE TH AE N
ليبيا|L IY B IY Y AE
ليت|L AE Y T AE
ليث|L AE Y TH
ليرة|L AE Y RRR AE
ليزر|L IY Z AE RRR
ليس|L AE Y S AE
ليل|L AE Y L
ليلة|L AE Y L AE
ليلتذاك|L AE Y L AE T AE DH AE K AE
ليلك|L IY L AE K
ليلي|L AE Y L IY Y Y
ليمو|L IY M UW
ليمون|L AE Y M UW N
ليموني|L AE Y M UW N IY Y Y
ليمي|L AE Y M IY Y Y
لينينية|L IY N IY N IY Y Y AE
م|M IY M
مآزق|M AE Q AE Z IY K
مأجوج|M AE Q D UW D
مأدبة|M AE Q D UW B AE
مأزق|M AE Q Z IY K
مأساة|M AH0 RH S AE T
مأكول|M AE Q K UW L
مأمأة|M AE Q M AE Q AE
مأوى|M AE Q W AE N
مؤامرة|M UW Q AE M AE RRR AE
مؤتمر|M UW Q T AE M AE RRR
مؤسس|M UW Q AE S S IY S
مؤسسة|M UW Q AE S S IY S AE
مؤشر|M UW Q AE SH SH IY RRR
مؤلف|M UW Q AE L L IY F
مؤمن|M UW Q M IY N
مؤنث|M UW Q AE N N AE TH
مئبر|M IY Q B AE RRR
مئة|M IY Q AE
مئذنة|M IY Q DH AE N AE
ما|M AE
ماء|M AE Q
مائت|M AE Q IY T
مائدة|M AE Q IY D AE
مات|M T
ماثل|M AE TH AE L AE
ماجد|M AE D IY D
ماجور|M AE D UW RRR
ماحق|M AE HH IY K
ماذا|M AE DH AE
مار|M AE RRR RRR
مارس|M AE RRR S
ماركسية|M AE RRR K S IY Y Y AE
ماز|M AE Z AE
مازريون|M AE Z AE RRR Y UW N
ماسح|M AE S IY HH
ماسورة|M AE S UW RRR AE
ماعون|M AE RH UW N
ماعونة|M AE RH UW N AE
مال|M AE L
مالاوي|M AE L AE W IY
مالج|M AE L AE D
مالح|M AE L IY HH
مالديفز|M AE L D IY F Z
مالطا|M AE L T AE
مالطي|M AE L T IY Y Y
مالق|M AE L AE K
مالقة|M AE L AE K AE
مالك|M AE L IY K
مالكي|M AE L IY K IY Y Y
ماليزيا|M AE L AE Y Z IY Y AE
ماما|M AE M AE
ماميثا|M AE M IY TH AE
مانشيت|M AE N SH EH0 T
مانيلا|M AE N IY L AE
ماه|M AE HH AE
ماهاراجا|M AE HH AE RRR AE D AE
مايو|M AE Y UW
مباح|M UW B AE HH
مباراة|M UW B AE RRR AE HH
مبارز|M UW B AE RRR IY Z
مبارزة|M UW B AE RRR AE Z AE
مبارك|M UW B AE RRR IY K
مبالغة|M UW B AE L AE HH AE
مبتل|M UW B T AE L IY N
مبتلى|M UW B T AE L AE N
مبدأ|M AE B D AE Q
مبرة|M AE B AE RRR RRR AE
مبرهنة|M UW B AE RRR HH AE N AE
مبشرة|M IY B SH AE RRR AE
مبكر|M UW B AE K K IY RRR
مبكرا|M UW B AE K K IY RRR AE N
مت|M AE T T AE
متأخرا|M UW T AE Q AE HH HH IY RRR AE N
متأسف|M UW T AE Q AE S S IY F
متأن|M UW T AE Q AE N N IY N
متاح|M UW T AE HH
متاع|M AE T AE RH
متانة|M AE T AE N AE
متة|M AE T EH0
متجر|M AE T D AE RRR
متحد|M UW T T AE HH IY D
متحمس|M UW T HH AE M IY S
متخصص|M UW T AE HH AE S S IY S
متخلف|M UW T AE HH AE L L IY F
متراس|M IY T RRR AE S
متزاوج|M UW T AE Z AE W IY D
متزوج|M UW T AE Z AE W W IY D
متسامح|M UW T AE S AE M IY HH
متسول|M UW T AE S AE W W IY L
متشابه|M UW T AE SH AE B IY HH
متشكر|M UW T AE SH AE K K IY RRR
متصل|M UW T T AE S IY L
متطرف|M UW T AE T AE RRR RRR IY F
متعة|M UW T RH AE
متعجرف|M UW T AE RH AE D RRR IY F
متعلم|M UW T AE RH AE L L IY M
متفجرات|M UW T AE F AE D D IY RRR AE T
متفرغ|M UW T AE F AE RRR RRR IY HH
متفرق|M UW T AE F AE RRR RRR IY K
متكبر|M UW T AE K AE B B IY RRR
متكدس|M UW T AE K AE D D IY S
متكلم|M UW T AE K AE L L IY M
متلوث|M UW T AE L AE W W IY TH
متماد|M UW T AE M AE D IY N
متناول|T AE N AE W AE L AE
متنزه|M UW T AE N AE Z Z IY HH
متنقض|M UW T AE N AE K K IY D
متنوع|M UW T AE N AE W W IY RH
متواضع|M UW T AE W AE D IY RH
متوسط|M UW T AE W AE S S IY T
متوفر|M UW T AE W AE F F IY RRR
متى|M AE T T AE
متين|M AE T IY N
مثابة|M AE TH AE B AE
مثار|M UW TH AE RRR
مثال|M IY TH AE L
مثانة|M AE TH AE N AE
مثقال|M IY TH K AE L
مثقب|M IY TH K AE B
مثل|M UW TH UW L
مثلا|M AE TH AE L AE N
مثلث|M UW TH AE L L AE TH
مثلجات|M UW TH AE L L AE D AE T
مثلجة|M AE TH L AE D AE
مثلي|M IY TH L IY Y Y
مثنان|M IY TH N AE N
مثنوية|M AE TH N AE W IY Y Y AE
مجادلة|M UW D AE D AE L AE HH
مجازر|M AE D AE Z IY RRR
مجازفة|M UW D AE Z AE F AE
مجازي|M AE D AE Z IY Y Y
مجاعة|M AE D AE RH AE
مجاهد|M UW D AE HH IY D
مجاور|M UW D AE W IY RRR
مجدد|M UW D AE D D IY D
مجراف|M IY D RRR AE F
مجرب|M UW D AE RRR RRR IY B
مجرد|M UW D AE RRR RRR AE D
مجرفة|M IY D RRR AE F AE
مجرم|M UW D RRR IY M
مجري|M AE D AE RRR IY Y Y
مجزر|M AE D Z AE RRR
مجسم|M UW D AE S S AE M
مجسمة|M UW D AE S S AE M AE
مجفل|M UW D AE F F IY L
مجلة|M AE D AE L L AE
مجلخة|M IY D L AE HH AE
مجلس|M AE D L IY S
مجمد|M UW D AE M M AE D
مجمر|M IY D M AE RRR
مجموع|M AE D M UW RH
مجموعة|M AE D M UW RH AE
مجن|M IY D AE N N
مجنون|M AE G N UW N
مجهر|M IY D HH AE RRR
مجوهرات|M UW D AE W HH AE RRR AE T
مجيء|M AE D IY Q
محا|M AE HH AE
محادث|M UW HH AE D IY TH
محادثة|M UW HH AE D IY TH AE
محار|M AE HH AE RRR
محارب|M UW HH AE RRR IY B
محاسبة|M UW HH AE S AE B AE
محاصر|M UW HH AE S IY RRR
محاصرة|M UW HH AE S AE RRR AE
محاضر|M UW HH AE D IY RRR
محاضرة|M UW HH AE D IY RRR AE
محافظ|M UW HH AE F IY DH
محافظة|M UW HH AE F IY DH AE
محاق|M UW HH AE K
محاكمة|M UW HH AE K AE M AE
محام|M UW HH AE M IY N
محاور|M UW HH AE W IY RRR
محايد|M UW HH AE Y IY D
محب|M UW HH IY B B
محبس|M IY HH B AE S
محبوس|M AE HH B UW S
محترف|M UW HH T AE RRR IY F
محجم|M IY HH D AE M
محجمة|M IY HH D AE M AE
محجوب|M AE HH D UW B
محدث|M UW HH AE D D IY TH
محدلة|M IY HH D AE L AE
محدود|M AE HH D UW D
محراب|M IY HH RRR AE B
محراث|M IY HH RRR AE TH
محرقة|M IY HH RRR AE K AE
محرك|M UW HH AE RRR RRR IY K
محسة|M IY HH AE S S AE
محسن|M UW HH S IY N
محشى|M UW HH AE SH SH AE N
محطة|M AE HH AE T T AE
محفظة|M IY HH F AE DH AE
محقق|M UH HH AA K K IH K
محل|M AE HH AE L L
محلي|M AE HH AE L L IY Y Y
محمد|M UW HH AE M M AE D
محمدة|M UW HH AE M M AE D AE
محمر|M UW HH AE M M AE RRR
محموم|M AE HH M UW M
محن|M IY HH AE N
محنة|M IY HH N AE
محول|M UW HH AE W W IY L
محى|M AE HH AE
محيص|M AE HH IY S
محيط|M UW HH IY T
محيل|M UW HH IY L
مخاض|M AE HH AE D
مخاط|M UW HH AE T
مخاطر|M AE HH AE T IY RRR
مخافة|M AE HH AE F AE
مخالف|M UW HH AE L IY F
مخبأ|M AE HH B AE Q
مخبر|M UW HH B IY RRR
مخبول|M AE HH B UW L
مختبر|M UW HH T AE B AE RRR
مختصر|M UW HH T AE S IY RRR
مختلف|M UW HH T AE L IY F
مخدر|M UW HH AE D D IY RRR
مخرج|M UW HH RRR IY D
مخرز|M IY HH RRR AE Z
مخرفة|M AE HH RRR AE F AE
مخروطي|M AE HH RRR UW T IY Y Y
مخصصات|M UW HH AE S S AE S AE T
مخصوص|M AE HH S UW S
مخض|M AE HH AE D AE
مخطئ|M UW HH T IY Q
مخطوب|M AE HH T UW B
مخطوطة|M AE HH T UW T AE
مخفر|M AE HH F AE RRR
مخلاة|M IY HH L AE HH
مخلة|M UW HH IY L L AE
مخلص|M UW HH L IY S
مخلوق|M AE HH L UW K
مخلوقات|M AE HH L UW K AE T
مخمل|M UW HH M AE L
مخنث|M UW HH AE N N AE TH
مخيط|M IY HH Y AE T
مخيم|M UW HH AE Y Y AE M
مداخل|M UW D AE HH IY L
مداخلة|M UW D AE HH AE L AE
مداد|M IY D AE D
مدافع|M AE D AE F IY RH
مدام|M UW D AE M
مداولة|M UW D AE W AE L AE
مداومة|M UW D AE W AE M AE
مدبر|M UW D AE B B IY RRR
مدة|M UW D D AE T AE
مدحلة|M IY D HH AE L AE
مدخن|M UW D AE HH HH IY N
مدرسة|M UW D AE RRR RRR IY S AE
مدرك|M UW D RRR IY K
مدع|M UW D D AE RH IY N
مدعى|M UW D D AE RH AE N
مدغشقر|M AE D AE HH AE SH K AE RRR
مدفأ|M IY D F AE Q
مدفأة|M IY D F AE Q AE
مدفع|M IY D F AE RH
مدق|M IY D AE K K
مدقة|M IY D AE K K AE
مدك|M IY D AE K K
مدلجة|M IY D L AE D AE
مدني|M AE D AE N IY Y Y
مدهش|M UW D HH IY SH
مدير|M UW D IY RRR
مديرة|M UW D IY RRR AE
مدينة|M AE D IY N AE
مذاق|M AE DH AE K
مذكر|M UW DH AE K K AE RRR
مذكرة|M UW DH AE K K IY RRR AE
مذهبي|M AE DH HH AE B IY Y Y
مذي|M AE DH IY
مذيع|M UW DH IY RH
مرآة|M IY RRR Q AE HH
مرأب|M AE RRR Q AE B
مرأة|M AE RRR Q AE
مراجع|M UW RRR AE D IY RH
مرادف|M UW RRR AE D IY F
مرارة|M AE RRR RRR AE RRR AE
مراري|M AE RRR AE RRR IY Y Y
مراسل|M UW RRR AE S IY L
مراغة|M AE RRR AE HH AE
مراكش|M UW RRR RRR AE K UW SH
مران|M UW RRR RRR AE N
مراهق|M UW RRR AE HH IY K
مراهقة|M UW RRR AE HH AE K AE
مراوغة|M UW RRR AE W AE HH AE
مربض|M AE RRR B IY D
مربوط|M AE RRR B UW T
مربى|M UW RRR AE B B AE
مرة|M UW RRR RRR AE
مرتبة|M AE RRR T AE B AE
مرتعب|M UW RRR T AE RH IY B
مرتفع|M UW RRR T AE F IY RH
مرجان|M AE RRR D AE N
مرجع|M AE RRR D IY RH
مرجل|M IY RRR D AE L
مرحاض|M IY RRR HH AE D
مرحبا|M AE RRR HH AE B AE
مرحلة|M AE RRR HH AE L AE
مرددوش|M AE RRR D AE D UW SH
مردقوش|M AE RRR D AE K UW SH
مردي|M UW RRR D IY Y Y
مرزبان|M AE RRR Z UW B AE N
مرزبة|M IY RRR Z AE B B AE
مرزنجوش|M AE RRR Z AE N D UW SH
مرسم|M AE RRR S AE M
مرسين|M AE RRR S IY N
مرش|M AE RRR SH
مرشة|M IY RRR AE SH SH AE
مرشد|M UW RRR SH IY D
مرصبان|M AE RRR S AE B AE N
مرصد|M AE RRR S AE D
مرطبان|M AE RRR T AE B AE N
مرفأ|M AE RRR F AE Q
مرفوع|M AE RRR F UW RH
مرقاق|M IY RRR K AE K
مرقة|M AE RRR AE K AE
مرقد|M AE RRR K AE D
مرقس|M AE RRR K UW S
مرقشيتا|M AE RRR K AE SH IY T AE
مرقشيثا|M AE RRR K AE SH IY TH AE
مرقص|M AE RRR K AE S
مركب|M UW RRR AE K K AE B
مرماخور|M AE RRR M AE HH UW RRR
مرند|M AE RRR AE N D
مرو|M AE RRR W
مروحة|M IY RRR W AE HH AE
مرور|M UW RRR UW RRR
مروض|M UW RRR AE W W IY D
مري|M UW RRR RRR IY
مريء|M AE RRR IY Q
مرية|M UW RRR Y AE
مريض|M AE RRR IY D
مريلة|M IY RRR Y AE L AE
مريم|M AE RRR Y AE M
مريمية|M AE RRR Y AE M IY Y Y AE
مرينة|M AE RRR IY N AE
مزاد|M AE Z AE D
مزبلة|M AE Z B AE L AE
مزج|M AE Z AE D AE
مزدهر|M UW Z D AE HH IY RRR
مزر|M IY Z RRR
مزرع|M AE Z RRR AE RH
مزرعة|M AE Z RRR AE RH AE
مزغل|M AE Z HH AE L
مزق|M AE Z Z AE K AE
مزمن|M UW Z M IY N
مزود|M UW Z AE W W IY D
مزورة|M UW Z AE W W AE RRR AE
مسؤول|M AE S Q UW L
مسؤولية|M AE S Q UW L IY Y Y AE
مسابقة|M UW S AE B AE K AE
مساحة|M IY S AE HH AE
مسار|M AE S AE RRR
مساطر|M AE S AE T IY RRR
مساعد|M UW S AE RH IY D
مساعدة|M UW S AE RH IY D AE
مسافة|M AE S AE F AE
مسافر|M UW S AE F IY RRR
مساهمة|M UW S AE HH AE M AE
مساواة|M UW S AE W AE HH
مساومة|M UW S AE W AE M AE
مستاجر|M UW S T AE Q D IY RRR
مستدير|M UW S T AE D IY RRR
مستشرق|M UW S T AE SH RRR IY K
مستشفى|M UW S T AE SH F AE N
مستطيل|M UW S T AE T IY L
مستطيلات|M UW S T T IY L AE T
مستعرب|M UW S T AE RH RRR IY B
مستفرغ|M UW S T AE F RRR IY HH
مستقبل|M UW S T AE G B AE L
مستقبلي|M UW S T AE K B AE L IY Y Y
مستقيم|M UW S T AE K IY M
مستند|M UW S T AE N AE D
مستنقع|M UW S T AE N K AE RH
مستنقعات|M UW S T AE N K AE RH AE T
مستهلك|M UW S T AE HH L IY K
مستوصف|M UW S T AE W S AE F
مستوقد|M UW S T AE W K AE D
مسجد|M AE S D IY D
مسجل|M UW S AE D D IY L
مسحق|M AE S HH AE K
مسخ|M AE S AE HH AE
مسد|M AE S S AE D AE
مسدس|M UW S AE D D AE S
مسرح|M AE S RRR AE HH
مسرحي|M AE S RRR AE HH IY Y Y
مسطار|M UW S T AE RRR
مسطح|M UW S AE T T AE HH
مسطرات|M IY S T AE RRR AE T
مسطرة|M IY S T AE RRR AE
مسعور|M AE S RH UW RRR
مسعى|M AE S RH AE N
مسقط|M AE S K AE T
مسكان|M UW S K AE N
مسكوكة|M AE S K UW K AE
مسكين|M IY S K IY N
مسلة|M IY S AE L L AE
مسلخ|M AE S L AE HH
مسلسل|M UW S AE L S IY L
مسلم|M UW S L IY M
مسلول|M AE S L UW L
مسمار|M IY S M AE RRR
مسموح|M AE S M UW HH
مسن|M UW S IY N N
مسود|M UW S W AE D D
مسى|M AE S AE
مسيح|M AE S IY HH
مسيحي|M AE S IY HH IY Y Y
مشأمة|M AE SH Q AE M AE HH
مشارة|M AE SH AE RRR AE
مشاعر|M AE SH AE RH IY RRR
مشانق|M AE SH AE N IY K
مشاهد|M UW SH AE HH IY D
مشاهدة|M UW SH AE HH AE D AE
مشاورة|M UW SH AE W AE RRR AE
مشاوير|M AE SH AE W IY RRR
مشاية|M AE SH SH AE Y AE
مشتاق|M UW SH T AE K
مشترك|M UW SH T AE RRR AE K
مشتريات|M UW SH T AE RRR AE Y AE T
مشجب|M IY SH D AE B
مشحذ|M IY SH HH AE DH
مشرب|M AE SH RRR AE B
مشربة|M IY SH RRR AE B AE
مشرع|M UW SH AE RRR RRR IY RH
مشرق|M AE SH RRR IY K
مشرقان|M AE SH RRR IY K AE N
مشرك|M UW SH RRR IY K
مشروع|M AE SH RRR UW RH
مشط|M UW SH T
مشعاع|M IY SH RH AE RH
مشعر|M AE SH RH AE RRR
مشعل|M IY SH RH AE L
مشغول|M AE SH HH UW L
مشقة|M AE SH AE K K AE
مشكل|M UW SH K IY L
مشكور|M AE SH K UW RRR
مشمش|M IY SH M IY SH
مشنة|M IY SH AE N N AE
مشهور|M AE SH HH UW RRR
مشواة|M IY SH W AE HH
مشوار|M IY SH W AE RRR
مشوه|M UW SH AE W W IY HH
مشوي|M AE SH W IY Y Y
مشى|M AE SH AE
مشيمة|M AE SH IY M AE
مص|M AE S S AE
مصاب|M UW S AE B
مصابحة|M UW S AE B AE HH AE
مصب|M AE S AE B B
مصبات|M AE S AE B B AE T
مصباح|M IY S B AE HH
مصبنة|M AE S B AE N AE
مصحنة|M IY S HH AE N AE
مصخفة|M IY S HH AE F AE
مصدق|M UW S AE D D AE K
مصدوم|M AE S D UW M
مصر|M IY S RRR
مصراع|M IY S RRR AE RH
مصطار|M UW S T AE RRR
مصطكاء|M UW S T AE K AE Q
مصطكى|M UW S T AE K AE
مصطلح|M UW S T AE L AE HH
مصعد|M IY S RH AE D
مصفاة|M IY S F AE HH
مصل|M AE S L
مصلب|M UW S AE L L IY B
مصلى|M UW S AE L L AE N
مصمم|M UW S AE M M IY M
مصنع|M AE S N AE RH UW N
مصهب|M UW S AE HH HH AE B
مصوع|M UW S AE W W AE RH
مصيبة|M UW S IY B AE
مصير|M AE S IY RRR
مضاربة|M UW D AE RRR AE B AE
مضايف|M AE D AE Y IY F
مضجع|M AE D D AE RH
مضرب|M IY D RRR AE B
مضض|M AE D AE D
مضمار|M IY D M AE RRR
مضمون|M AE D M UW N
مضيرة|M AE D IY RRR AE
مضيف|M UW D IY F
مضيفة|M AE D Y AE F AE
مضيق|M AE D IY K
مطار|M AE T AE RRR
مطاط|M AE T T AE T
مطاف|M AE T AE F
مطاو|M AE T AE W IY N
مطب|M AE T AE B B
مطبخ|M AE T B AE HH
مطبعة|M AE T B AE RH AE
مطحنة|M IY T HH AE N AE
مطران|M UW T RRR AE N
مطراني|M UW T RRR AE N IY Y Y
مطرانية|M UW T RRR AE N IY Y Y AE
مطرقة|M T AE RRR K AE
مطعم|M AE T RH AE M
مطفأة|M IY T F AE Q AE
مطواة|M IY T W AE HH
مظاهر|M AE DH AE HH IY RRR
مظلة|M IY DH AE L L AE
مظهر|M AE DH HH AE RRR
مع|M AE RH AE
معا|M AE RH AE N
معاء|M IY RH AE Q
معاداة|M UW RH AE D AE HH
معادلة|M UW RH AE D AE L AE
معارضة|M UW RH AE RRR AE D AE
معارف|M AE RH AE RRR IY F
معاصر|M UW RH AE S IY RRR
معانقة|M UW RH AE N AE K AE
معاون|M UW RH AE W IY N
معاونة|M UW RH AE W IY N AE
معاوية|M UW RH AE W IY Y AE
معاينة|M UW RH AE Y AE N AE
معبد|M AE RH B AE D
معبر|M AE RH B AE RRR
معبلة|M IY RH B AE L AE
معتبر|M UW RH T AE B IY RRR
معتدل|M UW RH T AE D IY L
معتزلة|M UW RH T AE Z IY L AE
معتقل|M UW RH T AE K AE L
معتل|M UW RH T AE L L
معجزات|M UW RH D IY Z AE T
معجزة|M UW RH D IY Z AE
معجم|M UW RH D AE M
معجون|M AE RH D UW N
معدات|M UW RH AE D D AE T
معدة|M IY RH D AE
معدن|M AE RH D IY N
معدود|M AE RH D UW D
معدوم|M AE RH D UW M
معدونس|M AE RH D UW N IY S
معراض|M IY RH RRR AE D
معرض|M AE RH RRR IY D
معركة|M AE RH RRR AE K AE
معروف|M AE RH RRR UW F
معزف|M IY RH Z AE F
معصم|M IY RH S AE M
معطس|M AE RH T IY S
معطف|M IY RH T AE F
معطى|M UW RH T AE N
معقل|M AE RH K IY L
معقود|M AE RH K UW D
معكرونة|M AE RH K AE RRR UW N AE
معلم|M UW RH L IY M
معمار|M IY RH M AE RRR
معماري|M IY RH M AE RRR IY Y Y
معمل|M AE RH M AE L
معمودية|M AE RH M UW D IY Y Y AE
معنوي|M AE RH N AE W IY Y Y
معنى|M AE RH N AE
معهد|M AE RH HH AE D
معول|M IY RH W AE L
معى|M IY RH AE N
معيار|M IY RH Y AE RRR
معير|M UW RH IY RRR
معين|M UW RH AE Y Y IY N
مغاث|M UW HH AE TH
مغامر|M UW HH AE M IY RRR
مغامرة|M UW HH AE M AE RRR AE
مغبن|M AE HH B AE N
مغذ|M UW HH AE DH DH IY N
مغرب|M UW HH RRR UW B
مغرفة|M IY HH RRR AE F AE
مغرور|M AE HH RRR UW RRR
مغزل|M IY HH Z AE L
مغسلة|M AE HH S IY L AE
مغضوب|M AE HH D UW B
مغطس|M IY HH T AE S
مغطى|M UW HH AE T T AE N
مغفرة|M AE HH F IY RRR AE
مغفل|M UW HH AE F F AE L
مغلاق|M IY HH L AE K
مغلف|M UW HH AE L L AE F
مغلق|M IY HH L AE K
مغلوب|M AE HH L UW B
مغن|M UW HH AE N N IY N
مغناطيس|M IY HH N AE T IY S
مغناطيسي|M IY HH N AE T IY S IY Y Y
مغناطيسية|M IY HH N AE T IY S IY Y Y AE
مغنط|M AE HH N AE T AE
مغنم|M AE HH N AE M
مغنيسيا|M AE HH N IY S IY Y AE
مغنيسيوم|M AE HH N IY S IY Y UW M
مغيب|M UW HH AE Y Y AE B
مغيم|M UW HH AE Y Y IY M
مفاجأة|M UW F AE D AE Q AE
مفاوضة|M UW F AE W AE D AE
مفت|M UW F T IY N
مفتاح|M IY F T AE HH
مفتش|M UW F AE T T IY SH
مفتعل|M UW F T AE RH AE L
مفرد|M UW F RRR AE D
مفرش|M IY F RRR AE SH
مفرط|M UW F RRR IY T
مفرغ|M UW F RRR IY HH
مفروشات|M AE F RRR UW SH AE T
مفروغ|M AE F RRR UW HH
مفسر|M UW F AE S S IY RRR
مفصل|M UW F AE S S AE L
مفك|M IY F AE K K
مفلس|M UW F L IY S
مفلفل|M UW F AE L F AE L
مفهوم|M AE F HH UW M
مفوف|M UW F AE W W AE F
مقابلة|M UW K AE B AE L AE
مقارنة|M UW K AE RRR AE N AE
مقاس|M AE G AE S
مقاص|M AE K AE S S
مقاطعة|M UW K AE T AE RH AE
مقاعد|M AE K AE RH IY D
مقالة|M AE K AE L AE
مقام|M AH0 K AE M
مقاود|M AE K AE W IY D
مقاولة|M UW K AE W AE L AE
مقايسة|M UW K AE Y AE S AE
مقبرة|M AE K B UW RRR AE
مقداد|M IY K D AE D
مقدار|M IY G D AE RRR
مقدر|M UW K AE D D AE RRR
مقدمة|M UW K AE D D IY M AE
مقدونس|M AE K D UW N IY S
مقدوني|M AE K D UW N IY Y Y
مقدونيا|M AE K D UW N IY Y AE
مقديشو|M AE K D IY SH UW
مقذاف|M IY K DH AE F
مقشدة|M IY K SH AE D AE
مقشرة|M IY K SH AE RRR AE
مقص|M IY K AE S S
مقصر|M UW K AE S S IY RRR
مقصف|M AE K S AE F
مقصلة|M IY K S AE L AE
مقصود|M AE K S UW D
مقطر|M UW K AE T T IY RRR
مقطع|M AE K T AE RH
مقطعية|M AE K T AE RH IY Y Y AE
مقع|M AE K AE RH AE
مقعد|M IY K RH AE D
مقعدة|M AE K RH AE D AE
مقلق|M UW K L IY K
مقلياثا|M AE K L IY Y AE TH AE
مقود|M IY K W AE D
مقولة|M AE K UW L AE
مكاء|M UW K K AE Q
مكار|M UW K AE RRR IY N
مكاريوس|M AE K AE RRR IY Y UW S
مكافح|M UW K AE F IY HH
مكالمة|M UW K AE L AE M AE
مكان|M AE K AE N
مكة|M AE K K AE
مكتب|M AE K T AE B
مكتبة|M AE K T AE B AE
مكث|M UW K TH
مكحلة|M UW K HH UW L AE
مكدس|M UW K AE D D IY S
مكسرات|M UW K AE S S AE RRR AE T
مكسور|M AE K S UW RRR
مكعب|M UW K AE RH RH AE B
مكمل|M UW K AE M M IY L
مكن|M AE K UW N AE
مكناس|M AE K N AE S
مكنسة|M IY K N AE S AE
مكوك|M AE K K UW K
مكون|M UW K AE W W IY N
مكياج|M IH K Y AA D
ملأك|M AE L Q AE K
ملا|M UW L L AE
ملاتيوس|M IY L AE T IY Y UW S
ملاحظ|M UW L AE HH IY DH
ملاحظة|M UW L AE HH AE DH AE
ملاحقة|M UW L AE HH AE K AE
ملاذ|M AE L AE DH
ملاط|M IY L AE T
ملاقاة|M UW L AE K AE HH
ملاك|M UW L L AE K
ملاكمة|M UW L AE K AE M AE
ملامح|M AE L AE M IY HH
ملبس|M AE L B AE S
ملجأ|M AE L D AE Q
ملح|M UW L HH AE
ملحس|M IY L HH AE S
ملحمي|M AE L HH AE M IY Y Y
ملحن|M UW L AE HH HH IY N
ملعقة|M IY L RH AE K AE
ملعون|M AE L RH UW N
ملف|M IY L AE F F
ملقن|M UW L AE K K IY N
ملك|M UW L L AE K
ملكة|M AE L IY K AE
ملكوت|M AE L AE K UW T
ملكي|M AE L AE K IY Y Y
ملل|M AE L L AE L AE
ملموم|M AE L M UW M
ملوخيا|M UW L UW HH IY Y Y AE
ملوخية|M UW L UW HH IY Y Y AE
ملوكيا|M UW L UW K IY Y Y AE
ملوكية|M UW L UW K IY Y Y AE
مليء|M AE L IY Q
مليار|M IY L Y AE RRR
مليق|M AE L IY K
مماثل|M UW M AE TH IY L
مماثلة|M UW M AE TH AE L AE
ممارسة|M UW M AE RRR AE S AE
مماس|M UW M AE S S
مماطلة|M UW M AE T AE L AE
ممتاز|M UW M T AE Z
ممتلئ|M UW M T AE L IY Q
ممتلكات|M UW M T AE L AE K AE T
ممثل|M UW M AE TH TH IY L
ممحوق|M AE M HH UW K
ممرض|M UW M AE RRR RRR IY D
ممسح|M UW M AE S S IY HH
ممسحة|M IY M S AE HH AE
ممسوح|M AE M S UW HH
ممكن|M UW M K IY N
مملوك|M AE M L UW K
ممن|M IY M M AE N
مميثا|M AE M M IY TH AE
من|M IY N
مناة|M AE N AE HH
مناخي|M AE N AE HH IY Y Y
منار|M AE N AE RRR
منارة|M AE N AE RRR AE
منازل|M AE N AE Z IY L
مناظرة|M UW N AE DH AE RRR AE
مناعة|M AE N AE RH AE
منافاة|M UW N AE F AE HH
منافس|M UW N AE F IY S
منافق|M UW N AE F IY K
مناقض|M UW N AE K IY D
منالاوس|M IY N AE L AE W UW S
منام|M AE N AE M
منبر|M IY N B AE RRR
منبه|M UW N AE B B IY HH
منتخب|M UW N T AE HH AE B
منتدى|M UW N T AE D AE
منتزه|M UW N T AE Z AE HH
منتصف|M UW N T AE S AE F
منتظر|M UW N T AE DH AE RRR
منتظم|M UW N T AE DH IY M
منتقض|M UW N T AE K IY D
منجاة|M AE N D AE HH
منجنيق|M AE N D AE N IY K
منجى|M AE N D AE N
منديل|M AE N D IY L
منذ|M UW N DH UW
منزل|M AE N Z IY L
منسأة|M IY N S AE Q AE
منسف|M IY N S AE F
منسوخ|M AE N S UW HH
منشأة|M UW N SH AE Q AE
منشار|M UW N SH AE RRR
منشفة|M IY N SH AE F AE
منصب|M AE N S IY B
منطقة|M AH0 N T AH0 G AH0
منطقي|M AE N T IY K IY Y Y
منظار|M IY N DH AE RRR
منظمة|M UW N AE DH DH AE M AE
منغوليا|M UW N HH UW L IY Y AE
منفاخ|M IY N F AE HH
منفضة|M IY N F AE D AE
منفور|M AE N F UW RRR
منفي|M AE N F IY Y Y
منقار|M IY N G AE RRR
منقرض|M UW N K AE RRR IY D
منقض|M UW N K IY D
منكب|M AE N K IY B
منهج|M IY N HH AE D
منور|M AE N W AE RRR
منون|M AE N UW N
منية|M AE N IY Y Y AE
منير|M UW N IY RRR
منيرة|M UW N IY RRR AE
مهابة|M AE HH AE B AE
مهاجر|M UW HH AE D IY RRR
مهاجم|M UW HH AE D IY M
مهارة|M AE HH AE RRR AE
مهدد|M UW HH AE D D AE D
مهدي|M AE HH D IY Y Y
مهذار|M IY HH DH AE RRR
مهراس|M IY HH RRR AE S
مهرة|M UW HH RRR AE
مهرجان|M IY HH RRR AE D AE N
مهلة|M UW HH L AE
مهم|M UW HH IY M M
مهماز|M IY HH M AE Z
مهنة|M IY HH N AE
مهندس|M UW HH AE N D IY S
مهوا|M AE HH W AE
مو|M UW
مواطن|M UW W AE T IY N
مواطنة|M UW W AE T IY N AE
موت|M AE W T
موتوسيكل|M OW0 T OW0 S IY K IY L
موجود|M AE W D UW D
موحد|M UW W AE HH HH IY D
موحش|M UW HH IY SH
مورد|M AE W RRR IY D
موريتانيا|M UW RRR IY T AE N IY Y AE
موز|M AE W Z
موزامبيق|M UW Z AE M B IY K
موزمبيق|M UW Z AE M B IY K
موسكو|M UW S K UW
موسم|M UW S IY M
موسمي|M AE W S IY M IY Y Y
موسى|M UW S AE
موسيقا|M UW S IY K AE
موسيقى|M UW S IY K AE
موضوع|M AE W D UW RH
موظف|M UW W AE DH DH AE F
موظفة|M UW W AE DH DH AE F AE
موقد|M AE W K IY D
موقع|M UW W AE K K IY RH
موقف|M AE W G IY F
موكب|M AE W K IY B
مولدوفا|M OW0 L D OW0 V AE
مولى|M AE W L AE N
مومس|M UW M IY S
مومسة|M UW M IY S AE
مومياء|M UW M IY Y AE Q
مونتريال|M UW N T RRR IY Y AE L
مويزج|M AE W IY Z AE D
مي|M AE Y Y
ميانمار|M IY Y AE N M AE RRR
ميتم|M AE Y T AE M
ميتوكندريا|M IY T UW K UW N D RRR IY Y AE
ميتوكندريون|M IY T UW K UW N D RRR IY Y UW N
ميثاق|M IY TH AE K
ميثرة|M IY TH AE RRR AE
ميدان|M AE Y D AE N
ميراث|M IY RRR AE TH
ميز|M AE Y Z
ميزان|M IY Z AE N
ميس|M AE Y S
ميضأة|M IY D AE Q AE
ميعاد|M IY RH AE D
ميكروويف|M AE Y K RRR OW0 W EH0 V
ميلاد|M IY L AE D
ميلق|M AE Y L AE K
ميم|M IY M
ميمنة|M AE Y M AE N AE
ميمون|M AE Y M UW N
مينا|M IY N AE
ميناء|M IY N AE Q
ميويزج|M IY W IY Z AE D
ن|N UW N
نأى|N AE Q AE
نائم|N AE Q IY M
ناجذ|N AE D IY DH
ناجود|N AE D UW D
ناح|N AE HH AE
ناحية|N AE HH IY Y AE
ناخوذاة|N AE HH UW DH AE HH
ناخوذة|N AE HH UW DH AE
نادرة|N AE D IY RRR AE
نادل|N AE D IY L
نادلة|N AE D IY L AE
نادى|N AE D AE
نار|N AE RRR
نارجيل|N AE RRR AE D IY L
ناردين|N AE RRR D IY N
نارنج|N AE RRR AE N D
نازع|N AE Z IY RH
ناسفة|N AE S IY F AE
ناسك|N AE S IY K
ناسور|N AE S UW RRR
ناشف|N AE SH IY F
ناصع|N AE S IY RH
ناصور|N AE S UW RRR
ناضج|N AE D IY D
ناط|N AE T AE
ناطف|N AE T IY F
ناظر|N AE DH IY RRR
ناعم|N AE RH IY M
ناعور|N AE RH UW RRR
ناعورة|N AE RH UW RRR AE
ناغش|N AE HH IY SH AE
نافذة|N AE F IY DH AE
نافلة|N AE F IY L AE
نافورة|N AE F UW RRR AE
نافى|N AE F AE
ناقص|N AE K IY S
ناقض|N AE K IY D
ناقل|N AE K IY L
ناقوس|N AE K UW S
نام|N AE M AE
ناموس|N AE M UW S
ناميبيا|N AE M IY B Y AE
نانخاة|N AE N AE HH AE HH
نانخة|N AE N AE HH AE
نانخواة|N AE N AE HH W AE HH
نانخوة|N AE N AE HH W AE
ناهز|N AE HH AE Z AE
ناووس|N AE W UW S
ناي|N AE Y
نبآء|N UW B AE Q AE Q
نبأ|N AE B AE Q
نبات|N AE B AE T
نباهة|N AE B AE HH AE
نبتون|N IY B T UW N
نبذة|N UW B DH AE
نبراس|N IY B RRR AE S
نبرة|N AE B RRR AE
نبهاء|N UW B AE HH AE Q
نبوغ|N UW B UW HH
نبي|N AE B IY Y Y
نبيل|N AE B IY L
نبيه|N AE B IY HH
نتأ|N AE T AE Q AE
نتج|N AE T AE D AE
نتف|N AE T AE F
نتوء|N UW T UW Q
نجاة|N AE D AE HH
نجاح|N AE D AE HH
نجار|N UW D AE RRR
نجاشي|N IY D AE SH IY Y Y
نجدة|N AE D D AE
نجى|N AE D D AE
نجي|N AE D IY Y Y
نحاس|N HH AE S
نحال|N AE HH HH AE L
نحل|N AE HH L
نحلة|N AE HH L AE
نحن|N UW HH N AE
نحيل|N AE HH IY L
نخاس|N AE HH HH AE S
نخاسة|N IY HH AE S AE
نخاع|N UW HH AE RH
نخالة|N UW HH HH AE L AE
نخروبي|N UW HH RRR UW B IY Y Y
نخشوش|N AE HH SH UW SH
نخل|N AE HH HH AE L AE
نخلة|N AE HH L AE
نخوة|N AE HH W AE
ندامة|N AE D AE M AE
ندبة|N UW D B AE
ندد|N AE D D AE D AE
ندم|N AE D IY M AE
ندوات|N AE D AE W AE T
ندوة|N UW D UW W W AE
ندى|N AE D AE
نذل|N AE DH L
نذير|N AE DH IY RRR
نرجيل|N AE RRR D IY L
نرفز|N AE RRR F AE Z AE
نرويجية|N UW RRR W IY D IY Y Y AE
نزعة|N AE Z RH AE
نزلة|N AE Z L AE
نزهة|N UW Z HH AE
نزية|N AE Z IY Y Y AE
نزيل|N AE Z IY L
نسأ|N AE S AE Q AE
نساء|N IY S AE Q
نساب|N AE S S AE B
نسبوية|N IY S B AE W IY Y Y AE
نسبي|N IY S B IY Y Y
نسبيا|N IY S B IY Y Y AE N
نستعليق|N AE S T AE RH L IY K
نسخ|N AE S HH
نسخة|N UW S HH AE
نسرين|N IY S RRR IY N
نسكي|N UW S UW K IY Y Y
نسمة|N AE S AE M AE
نسوان|N UW S W AE N
نسى|N AE S S AE
نسيئة|N AE S IY Q AE
نسيم|N AE S IY M
نشادر|N UW SH AE D IY RRR
نشاطية|N AE SH AE T IY Y Y AE
نشد|N AE SH AE D AE
نشرة|N AE SH RRR AE
نشل|N AE SH L
نشور|N UW SH UW RRR
نشيد|N AE SH IY D
نشيدة|N AE SH IY D AE
نص|N AE S S
نصاب|N AE S S AE B
نصراني|N AE S RRR AE N IY Y Y
نضار|N UW D AE RRR
نضب|N AE D AE B AE
نضو|N IY D W
نضوج|N UW D UW D
نضي|N AE D IY Y Y
نضيج|N AE D IY D
نطاق|N IY T AE K
نطل|N AE T AE L AE
نظارة|N AE DH DH AE RRR AE
نظام|N IY DH AE M
نظامي|N IY DH AE M IY Y Y
نظر|N IY DH RRR
نظرية|N AE DH AE RRR IY Y Y AE
نظف|N AE DH DH AE F AE
نظير|N AE DH IY RRR
نظيف|N AE DH IY F
نعاس|N UW RH AE S
نعال|N IY RH AE L
نعامة|N AE RH AE M AE
نعجة|N AE RH D AE
نعس|N AE RH AE S AE
نعل|N AE RH RH AE L AE
نعم|N AE RH AE M
نعمة|N IY RH M AE
نعناع|N AE RH N AE RH
نعوظ|N UW RH UW DH
نعيم|N AE RH IY M
نغمة|N AE HH M AE
نفاخة|N UW F F AE HH AE
نفاد|N AE F AE D
نفاذ|N AE F AE DH
نفث|N AE F AE TH AE
نفخ|N AE F HH
نفس|N AE F S
نفض|N AE F F AE D AE
نفط|N IY F T
نفقة|N AE F AE K AE
نفوذ|N UW F UW DH
نق|N AE K K AE
نقاب|N IY K AE B
نقحر|N AE K HH AE RRR AE
نقدا|N AE K D AE N
نقصان|N UW K S AE N
نقض|N UW K D AE
نقطة|N UW K T AE
نقيض|N AE K IY D
نكاح|N IY K AE HH
نكبة|N AE K B AE
نمر|N AE M IY RRR
نمط|N AE M AE T
نملة|N AE M L AE
نموذج|N AE M UW DH AE D
نموذجي|N AE M UW DH AE D IY Y Y
نهائي|N IY HH AE Q IY Y Y
نهار|N AE HH AE RRR
نهاية|N IY HH AE Y AE
نهب|N AE HH AE B AE
نهر|N AE HH RRR
نهز|N AE HH AE Z AE
نهزة|N UW HH Z AE
نهض|N AE HH D
نهضة|N AE HH D AE
نهق|N AE HH AE K AE
نهى|N AE HH AE
نواجذ|N AE W AE D IY DH
نواخذة|N AE W AE HH IY DH AE
نواكشوط|N UW W AE K SH UW T
نوح|N UW HH
نور|N UW RRR
نوراني|N UW RRR AE N IY Y Y
نورج|N AE W RRR AE D
نورس|N AE W RRR AE S
نوع|N AE W RH
نوفمبر|N UW F IY M B IY RRR
نوم|N AE W W AE M AE
نون|N UW N
نوه|N AE W W AE HH AE
نيابة|N IY Y AE B AE
نياحة|N IY Y AE HH AE
نياط|N IY Y AE T
نيبال|N IY P AE L
نية|N IY Y Y AE
نيتروجين|N IY T RRR OW0 ZH EH0 N
نيجيريا|N IY G IY RRR IY Y AE
نير|N AE Y Y IY RRR
نيشان|N IY SH AE N
نيفق|N AE Y F AE K
نيكاراغوا|N IY K AE RRR AE HH UW W AE
نيلج|N IY L AE D
نيلي|N IY L IY Y Y
نيوزيلاندا|N IY Y UW Z IY L AE N D AE
نيويورك|N IY Y UW Y OW0 RRR K
ه|HH AE Q
هؤلاء|HH AE Q UW L AE Q IY
ها|HH AE
هاء|HH AE Q AE
هائل|HH AE Q IY L
هاب|HH AE B AE
هابيل|HH AE B IY L
هاتف|HH AE T IY F
هاته|HH AE T IY HH IY
هاجم|HH AE D AE M AE
هاد|HH AE D AE
هادي|HH AE D IY
هارب|HH AE RRR IY B
هارون|HH AE RRR UW N
هازباء|HH AE Z IY B AE Q
هال|HH AE L AE
هالك|HH AE L IY K
هالوك|HH AE L UW K
هامش|HH AE M IY SH
هانم|HH AE N IY M
هاون|HH AE W UW N
هايتي|HH AE Y IY T IY
هباء|HH AE B AE Q
هبة|HH IY B B AE
هبد|HH AE B D
هبيد|HH AE B IY D
هتف|HH AE T AE F AE
هتك|HH AE T AE K AE
هجاء|HH IY D AE Q
هجران|HH IY D RRR AE N
هجرة|HH IY D RRR AE
هجليج|HH IY D L IY D
هجم|HH AE D AE M AE
هجوم|HH UW D UW M
هجى|HH AE D D AE AE
هدار|HH AE D D AE RRR
هدد|HH AE D D AE D AE
هدس|HH AE D AE S
هدف|HH AE D AE F
هدم|HH AE D M
هدهد|HH UW D HH UW D
هدى|HH UW D AE N
هدية|HH AE D IY Y Y AE
هذا|HH AE DH AE
هذب|HH AE DH DH AE B AE
هذر|HH AE DH IY RRR AE
هذه|HH AE DH IY HH IY
هذى|HH AE DH AE
هذيان|HH AE DH AE Y AE N
هر|HH IY RRR RRR
هراش|HH IY RRR AE SH
هراوات|HH IY RRR AE W AE T
هراوة|HH IY RRR AE W AE
هراوى|HH AE RRR AE W AE
هرة|HH IY RRR RRR AE T UW N
هرد|HH UW RRR UW D
هرنوة|HH AE RRR N UW W AE
هرول|HH AE RRR W AE L
هرولة|HH AE RRR W AE L AE
هريرة|HH UW RRR AE Y RRR AE T UW N
هزة|HH IY Z Z AE
هزج|HH AE Z IY D AE
هزر|HH AE Z AE RRR AE
هزل|HH AE Z L
هزيز|HH AE Z IY Z
هزيل|HH AE Z IY L
هزيمة|HH AE Z IY M AE
هش|HH AE SH SH AE
هطل|HH AE T AE L AE
هطلس|HH AE T AE L L AE S
هعخع|HH UW RH HH UW RH
هفا|HH AE F AE
هفو|HH AE F W
هكذا|HH AE K AE DH AE
هل|HH AE L
هلاك|HH AE L AE K
هلسنكي|HH IY L S IY N K IY
هللة|HH AE L AE L AE
هلهل|HH AE L HH AE L AE
هم|HH UW M
هما|HH UW M AE
همجي|HH AE M AE D IY Y Y
همدان|HH AE M D AE N
همزة|HH UW M AE Z AE
همس|HH AE M S
هميان|HH IY M Y AE N
هن|HH UW N N AE
هنا|HH UW N AE
هنادة|AE L HH AE N AE D AE
هناك|HH UW N AE K AE
هنالك|HH UW N AE L IY K AE
هندباء|HH IY N D IY B AE Q
هندس|HH AE N D AE S AE
هندسة|HH AE N D AE S AE
هندسي|HH AE N D AE S IY Y Y
هنغاري|HH UW N HH AE RRR IY Y Y
هنغاريا|HH UW N HH AE RRR IY Y AE
هنيهة|HH UW N AE Y HH AE
ههنا|HH AE HH UW N AE
ههناك|HH AE HH UW N AE K AE
هو|W AE HH W AE
هواء|HH AE W AE Q
هوادة|HH AE W AE D AE
هوة|HH UW W W AE
هوتة|HH UW T AE
هود|HH UW D
هودج|HH AE W D AE D
هوري|HH UW RRR IY Y Y
هوشة|HH AE W SH AE
هول|HH AE W L
هوندوراس|HH OW0 N D UW RRR AE S
هويات|HH UW W IY Y Y AE T
هي|HH IY Y AE
هيئة|HH AE Y Q AE
هيا|HH AE Y Y AE
هيبة|HH IY B AE
هيدروجين|HH IY D RRR OW0 ZH EH0 N
هيف|HH AE Y IY F AE
هيكل|HH AE Y K AE L
هيمنة|HH AE Y M AE N AE
هيول|HH AE Y UW L
و|W IH
وأد|W AE Q D
وأى|W AE Q AE
وا|W AE
وابل|W AE B IY L
وابور|W AE B UW RRR
واثق|W AE TH IY K
واجه|W AE D AE HH AE
واجهات|W AE D IY HH AE T
واجهة|W AE D IY HH AE
واحات|W AE HH AE T
واحة|W AE HH AE
واحد|W AE HH IY D
واحدة|W AE HH IY D AE
واد|W AE D IY N
وارث|W AE RRR IY TH
وارسو|W AE RRR S UW
واس|W AE S
واسع|W AE S IY RH
واشنطن|W AE SH IY N T UW N
واطن|W AE T AE N AE
واظب|W AE DH AE B AE
واعد|W AE RH AE D AE
وافق|W AE F AE K AE
واق|W AE K IY N
واقع|W AE K IY RH
واقعة|W AE K IY RH AE
واقعي|W AE K IY RH IY Y Y
والله|W AE L L AE HH IY
واه|W AE HH IY N
واو|W AE W
وبال|W AE B AE L
وبخ|W AE B B AE HH AE
وبل|W AE B AE L AE
وبيل|W AE B IY L
وتدي|W AE T AE D IY Y Y
وتيرة|W AE T IY RRR AE
وتين|W AE T IY N
وثق|W AE TH TH AE K AE
وثني|W AE TH AE N IY Y Y
وثيق|W AE TH IY K
وثيقة|W AE TH IY K AE
وجب|W AE D D AE B AE
وجبة|W AE D B AE
وجد|W AE D D
وجدة|W AE D D AE
وجنة|W AE D N AE
وجهة|W UW D HH AE
وجود|W UW D UW D
وجوم|W UW D UW M
وجيز|W AE D IY Z
وحدة|W AE HH D AE
وحل|W AE HH L
وحمة|W AE HH M AE
وداعا|W AE D AE RH AE N
ودامون|W AE D AE M UW N
ودج|Q AE W D AE D
وديعة|W AE D IY RH AE
وراثة|W IY RRR AE TH AE
وراط|W IY RRR AE T
وردة|W AE RRR D AE
وردي|W AE RRR D IY Y Y
ورس|W UW RRR UW S
ورشان|W AE RRR AE SH AE N
ورشنوفة|W AE RRR SH AE N UW F AE
ورطة|W AE RRR T AE
ورق|W AE RRR AE K
ورقة|W AE RRR AE K AE
ورل|W AE RRR AE L
ورن|W AE RRR AE N
وروار|W AE RRR W AE RRR
ورى|W AA RRR AH0
وريد|W AE RRR IY D
وزارة|W IY Z AE RRR AE
وزراء|W UW Z AE RRR AE Q
وزع|W AE Z Z AE RH AE
وزغ|W AE Z AE HH
وزغة|W AE Z AE HH AE
وزنة|W AE Z N AE
وسام|W IY S AE M
وسخ|W AE S IY HH
وسد|W AE S S AE D AE
وسط|W UW S AE T
وسع|W AE S UW RH AE
وسق|W AE S K
وسمة|W AE S M AE
وشاح|W IY SH AE HH
وشك|W UW SH K
وشيك|W AE SH IY K
وصاية|W IY S AE Y AE
وصفة|W AE S F AE
وصى|W AE S S AE
وصية|W AE S IY Y Y AE
وصيد|W AE S IY D
وصيف|W AE S IY F
وضاح|W AE D D AE HH
وضب|W AE D D AE B AE
وضح|W AE D D AE HH AE
وضع|W AE D RH
وضعية|W AE D RH IY Y Y AE
وضوء|W UW D UW Q
وضوح|W UW D UW HH
وطني|W AE T AE N IY Y Y
وظف|W UW DH UW F
وظيفة|W AE DH IY F AE
وعاء|W IY RH AE Q
وعد|W AE RH D
وعدة|W AE RH D AE
وعليكم|W AE RH AE L AE Y K UW M
وعي|W AE RH Y
وغد|W AE HH UW D AE
وغل|W AE HH AE L AE
وفاء|W AE F AE Q
وفق|W AE F IY K AE
وفي|W AE F IY Y Y
وقاء|W IY K AE Q
وقار|W AE K AE RRR
وقت|W AE Q T
وقتئذ|W AE K T AE Q IY DH IY N
وقتذاك|W AE K T AE DH AE K AE
وقع|W AE K RH
وقف|W AE K K AE F AE
وقود|W AE K UW D
وقية|W UW K IY Y Y AE
ولاعة|W AE L L AE RH AE
ولاية|W IY L AE Y AE
ولد|W AE L L AE D AE
ولكن|W AE L AE K IY N N AE
ولو|W AE L AE W
ولى|W AE L L AE
وليمة|W AE L IY M AE
ومض|W AE M AE D AE
ونش|W IY N SH
وهاج|W AE HH HH AE D
وهلة|W AE HH L AE
وهمي|W AE HH M IY Y Y
ووفق|W UW F IY K AE
ويبة|W IY B AE
ويسكي|W IY S K IY
ويكاموس|W IY K AE M UW S
ويكة|W EH0 K AE
ويكي|W IY K IY
ويكيبيديا|W IY K IY B IY D IY Y AE
ي|Y AE Q
يأجوج|Y AE Q D UW D
يؤيؤ|Y UW Q Y UW Q
يا|Y AE
ياء|Y AE Q
ياالله|Y AE L L AE
يابس|Y AE B IY S
ياسمين|Y AE S AE M IY N
ياسين|Y AE S IY N
يافث|Y AE F AE TH
يافع|Y AE F IY RH
يافوخ|Y AE F UW HH
يانسون|Y AE N AE S UW N
يانصيب|Y AE N AE S IY B
ياي|Y AE Y
يبروح|Y AE B RRR UW HH
يبس|Y AE B IY S AE
يتوع|Y AE T T UW RH
يتيم|Y AE T IY M
يثرب|Y AE TH RRR IY B
يحبور|Y AE HH B UW RRR
يحيى|Y AE HH Y AE
يخت|Y AE HH T
يد|Y AE D
يراع|Y AE RRR AE RH
يربوز|Y AE RRR B UW Z
يربوع|Y AE RRR B UW RH
يرقة|Y AE RRR AE Q AE
يسار|Y UW S AE RRR UW
يسروع|Y UW S RRR UW RH
يسوع|Y AE S UW RH
يشوع|Y AE SH UW RH
يعضيض|Y AE RH D IY D
يعقوب|Y AE RH K UW B
يعني|Y AE RH N IY
يقظة|Y AE K AE DH AE
يقين|Y AE K IY N
يلا|Y AE L L AE
يلب|Y AE L AE B
يمام|Y AE M AE M
يمين|Y AE M IY N
يناير|Y AE N AE Y IY RRR
ينبوع|Y AE N B UW RH
ينسون|Y AE N S UW N
ينع|Y AE N AE RH AE
يهوه|Y AE HH W AE HH
يوجوسلافيا|Y UW G UW S L AE V IY Y AE
يوحنا|Y UW HH AE N N AE
يورانيم|Y UW RRR AE N Y UW M
يورو|Y UW RRR OW0
يوسف|Y UW S UW F
يوشع|Y UW SH AE RH
يوليو|Y UW L IY Y UW
يوم|Y AE W M
يوميا|Y AE W M IY Y Y AE N
يوناني|Y UW N AE N IY Y Y
يونس|Y UW N UW S
يونيو|Y UW N IY Y UW
ڤ|V